Year,Region,Industry,Professional Position Category,Gross Pay Total,Gross Pay Women,Gross Pay Men,Gender Pay Gap
2020,Lake Geneva,TOTAL,Total ,6731,6544,6866,322
2020,Lake Geneva,SECTOR 2 PRODUCTION,Total ,6591,6159,6673,514
2020,Lake Geneva,Mining and quarrying,Total ,6279,0,6261,6261
2020,Lake Geneva,Manufacturing of Goods,Total ,6859,6154,7099,945
2020,Lake Geneva,Waste disposal,Total ,6028,6469,6005,-464
2020,Lake Geneva,Construction ,Total ,6220,5892,6234,342
2020,Lake Geneva,SECTOR 3 SERVICES ,Total ,6796,6592,7000,408
2020,Lake Geneva,Wholesale and retail trade,Total ,5868,5377,6179,802
2020,Lake Geneva,Transportation and storage,Total ,6078,5931,6123,192
2020,Lake Geneva,Hotels and restaurants,Total ,4463,4328,4642,314
2020,Lake Geneva,Information and communication,Total ,8424,7226,8876,1650
2020,Lake Geneva,Financial and insurance services,Total ,9981,8076,11333,3257
2020,Lake Geneva,Professional services,Total ,7984,7196,8506,1310
2020,Lake Geneva,Other business services,Total ,5463,4986,5622,636
2020,Lake Geneva,Health and social work,Total ,6758,6580,7267,687
2020,Lake Geneva,Arts and recreation,Total ,7192,7164,7221,57
2020,Lake Geneva,Other service activities,Total ,6668,6150,7429,1279
2020,Lake Geneva,TOTAL,T/U/M Management,11200,9905,11758,1853
2020,Lake Geneva,SECTOR 2 PRODUCTION,T/U/M Management,10300,9571,10424,853
2020,Lake Geneva,Mining and quarrying,T/U/M Management,0,0,0,0
2020,Lake Geneva,Manufacturing of Goods,T/U/M Management,11719,10940,11798,858
2020,Lake Geneva,Waste disposal,T/U/M Management,11113,0,11663,11663
2020,Lake Geneva,Construction ,T/U/M Management,8749,7805,8791,986
2020,Lake Geneva,SECTOR 3 SERVICES ,T/U/M Management,11447,9987,12164,2177
2020,Lake Geneva,Wholesale and retail trade,T/U/M Management,10682,9660,11182,1522
2020,Lake Geneva,Transportation and storage,T/U/M Management,7823,5050,8824,3774
2020,Lake Geneva,Hotels and restaurants,T/U/M Management,6158,5736,6291,555
2020,Lake Geneva,Information and communication,T/U/M Management,11213,8941,11503,2562
2020,Lake Geneva,Financial and insurance services,T/U/M Management,17016,13889,18218,4329
2020,Lake Geneva,Professional services,T/U/M Management,13210,10831,14004,3173
2020,Lake Geneva,Other business services,T/U/M Management,9580,9343,9633,290
2020,Lake Geneva,Health and social work,T/U/M Management,11504,10483,12515,2032
2020,Lake Geneva,Arts and recreation,T/U/M Management,10140,9511,10527,1016
2020,Lake Geneva,Other service activities,T/U/M Management,9290,8599,10010,1411
2020,Lake Geneva,TOTAL,Lower management,9402,8968,9688,720
2020,Lake Geneva,SECTOR 2 PRODUCTION,Lower management,9577,10642,9370,-1272
2020,Lake Geneva,Mining and quarrying,Lower management,0,0,0,0
2020,Lake Geneva,Manufacturing of Goods,Lower management,10318,11400,10056,-1344
2020,Lake Geneva,Waste disposal,Lower management,8514,0,8686,8686
2020,Lake Geneva,Construction ,Lower management,7685,7394,7726,332
2020,Lake Geneva,SECTOR 3 SERVICES ,Lower management,9370,8828,9800,972
2020,Lake Geneva,Wholesale and retail trade,Lower management,9851,8741,10883,2142
2020,Lake Geneva,Transportation and storage,Lower management,7814,8065,7814,-251
2020,Lake Geneva,Hotels and restaurants,Lower management,5672,5297,6086,789
2020,Lake Geneva,Information and communication,Lower management,10028,8856,10585,1729
2020,Lake Geneva,Financial and insurance services,Lower management,11680,11075,12023,948
2020,Lake Geneva,Professional services,Lower management,9436,9647,9386,-261
2020,Lake Geneva,Other business services,Lower management,6700,7128,6615,-513
2020,Lake Geneva,Health and social work,Lower management,8733,8408,9185,777
2020,Lake Geneva,Arts and recreation,Lower management,9358,9125,9718,593
2020,Lake Geneva,Other service activities,Lower management,8271,8075,8508,433
2020,Lake Geneva,TOTAL,Lowest management,7385,7149,7511,362
2020,Lake Geneva,SECTOR 2 PRODUCTION,Lowest management,7386,7673,7367,-306
2020,Lake Geneva,Mining and quarrying,Lowest management,0,0,0,0
2020,Lake Geneva,Manufacturing of Goods,Lowest management,7720,8231,7590,-641
2020,Lake Geneva,Waste disposal,Lowest management,6771,0,6786,6786
2020,Lake Geneva,Construction ,Lowest management,7100,6738,7134,396
2020,Lake Geneva,SECTOR 3 SERVICES ,Lowest management,7384,7103,7624,521
2020,Lake Geneva,Wholesale and retail trade,Lowest management,6823,6707,6864,157
2020,Lake Geneva,Transportation and storage,Lowest management,7559,6808,7677,869
2020,Lake Geneva,Hotels and restaurants,Lowest management,5010,4779,5157,378
2020,Lake Geneva,Information and communication,Lowest management,8571,7551,8870,1319
2020,Lake Geneva,Financial and insurance services,Lowest management,9934,8832,10809,1977
2020,Lake Geneva,Professional services,Lowest management,7986,7322,8141,819
2020,Lake Geneva,Other business services,Lowest management,5900,5466,6005,539
2020,Lake Geneva,Health and social work,Lowest management,6916,6805,7131,326
2020,Lake Geneva,Arts and recreation,Lowest management,7582,7736,7367,-369
2020,Lake Geneva,Other service activities,Lowest management,7040,7002,7190,188
2020,Lake Geneva,TOTAL,No management,6092,6092,6092,0
2020,Lake Geneva,SECTOR 2 PRODUCTION,No management,6125,5701,6211,510
2020,Lake Geneva,Mining and quarrying,No management,6044,0,6044,6044
2020,Lake Geneva,Manufacturing of Goods,No management,6262,5650,6502,852
2020,Lake Geneva,Waste disposal,No management,5720,5970,5687,-283
2020,Lake Geneva,Construction ,No management,5974,5670,6003,333
2020,Lake Geneva,SECTOR 3 SERVICES ,No management,6074,6155,5999,-156
2020,Lake Geneva,Wholesale and retail trade,No management,5063,4804,5271,467
2020,Lake Geneva,Transportation and storage,No management,5671,5849,5639,-210
2020,Lake Geneva,Hotels and restaurants,No management,4282,4161,4333,172
2020,Lake Geneva,Information and communication,No management,7372,6631,7701,1070
2020,Lake Geneva,Financial and insurance services,No management,7143,6780,7835,1055
2020,Lake Geneva,Professional services,No management,6679,6480,6909,429
2020,Lake Geneva,Other business services,No management,5339,4842,5515,673
2020,Lake Geneva,Health and social work,No management,6478,6382,6758,376
2020,Lake Geneva,Arts and recreation,No management,6284,6411,6196,-215
2020,Lake Geneva,Other service activities,No management,5475,5000,6197,1197
2018,Lake Geneva,TOTAL,Total ,6600,6442,6720,278
2018,Lake Geneva,SECTOR 2 PRODUCTION,Total ,6453,6122,6514,392
2018,Lake Geneva,Mining and quarrying,Total ,6314,0,6306,6306
2018,Lake Geneva,Manufacturing of Goods,Total ,6683,5992,6930,938
2018,Lake Geneva,Waste disposal,Total ,6128,5716,6159,443
2018,Lake Geneva,Construction ,Total ,6086,6500,6053,-447
2018,Lake Geneva,SECTOR 3 SERVICES ,Total ,6667,6479,6888,409
2018,Lake Geneva,Wholesale and retail trade,Total ,5818,5302,6233,931
2018,Lake Geneva,Transportation and storage,Total ,5887,5850,5900,50
2018,Lake Geneva,Hotels and restaurants,Total ,4335,4222,4476,254
2018,Lake Geneva,Information and communication,Total ,8334,7070,8750,1680
2018,Lake Geneva,Financial and insurance services,Total ,9611,7965,11091,3126
2018,Lake Geneva,Professional services,Total ,8054,7164,8889,1725
2018,Lake Geneva,Other business services,Total ,5265,4979,5340,361
2018,Lake Geneva,Health and social work,Total ,6648,6461,7152,691
2018,Lake Geneva,Arts and recreation,Total ,7494,7334,7619,285
2018,Lake Geneva,Other service activities,Total ,6633,6066,7445,1379
2018,Lake Geneva,TOTAL,T/U/M Management,11178,9750,11902,2152
2018,Lake Geneva,SECTOR 2 PRODUCTION,T/U/M Management,9693,7866,10346,2480
2018,Lake Geneva,Mining and quarrying,T/U/M Management,0,0,0,0
2018,Lake Geneva,Manufacturing of Goods,T/U/M Management,10870,9277,11124,1847
2018,Lake Geneva,Waste disposal,T/U/M Management,10682,0,10777,10777
2018,Lake Geneva,Construction ,T/U/M Management,7916,0,8284,8284
2018,Lake Geneva,SECTOR 3 SERVICES ,T/U/M Management,11527,10135,12250,2115
2018,Lake Geneva,Wholesale and retail trade,T/U/M Management,10872,10409,11269,860
2018,Lake Geneva,Transportation and storage,T/U/M Management,9841,9699,9883,184
2018,Lake Geneva,Hotels and restaurants,T/U/M Management,5672,4983,6190,1207
2018,Lake Geneva,Information and communication,T/U/M Management,11305,10147,11607,1460
2018,Lake Geneva,Financial and insurance services,T/U/M Management,16667,13955,17667,3712
2018,Lake Geneva,Professional services,T/U/M Management,12607,10002,13255,3253
2018,Lake Geneva,Other business services,T/U/M Management,9494,8249,9951,1702
2018,Lake Geneva,Health and social work,T/U/M Management,11111,10319,11918,1599
2018,Lake Geneva,Arts and recreation,T/U/M Management,10295,9341,11158,1817
2018,Lake Geneva,Other service activities,T/U/M Management,9608,8742,10098,1356
2018,Lake Geneva,TOTAL,Lower management,9114,8583,9462,879
2018,Lake Geneva,SECTOR 2 PRODUCTION,Lower management,9137,9179,9121,-58
2018,Lake Geneva,Mining and quarrying,Lower management,0,0,0,0
2018,Lake Geneva,Manufacturing of Goods,Lower management,9753,10220,9670,-550
2018,Lake Geneva,Waste disposal,Lower management,8516,0,8686,8686
2018,Lake Geneva,Construction ,Lower management,6953,6122,7219,1097
2018,Lake Geneva,SECTOR 3 SERVICES ,Lower management,9111,8550,9572,1022
2018,Lake Geneva,Wholesale and retail trade,Lower management,9582,8602,10429,1827
2018,Lake Geneva,Transportation and storage,Lower management,8202,0,8287,8287
2018,Lake Geneva,Hotels and restaurants,Lower management,4950,4717,5102,385
2018,Lake Geneva,Information and communication,Lower management,10000,8895,10290,1395
2018,Lake Geneva,Financial and insurance services,Lower management,11242,10725,11491,766
2018,Lake Geneva,Professional services,Lower management,10762,9921,11382,1461
2018,Lake Geneva,Other business services,Lower management,6910,7041,6845,-196
2018,Lake Geneva,Health and social work,Lower management,8568,8413,8830,417
2018,Lake Geneva,Arts and recreation,Lower management,10001,9196,10804,1608
2018,Lake Geneva,Other service activities,Lower management,8392,8112,8875,763
2018,Lake Geneva,TOTAL,Lowest management,7320,7092,7453,361
2018,Lake Geneva,SECTOR 2 PRODUCTION,Lowest management,7272,7500,7206,-294
2018,Lake Geneva,Mining and quarrying,Lowest management,0,0,0,0
2018,Lake Geneva,Manufacturing of Goods,Lowest management,7834,7584,7879,295
2018,Lake Geneva,Waste disposal,Lowest management,5778,0,5984,5984
2018,Lake Geneva,Construction ,Lowest management,6500,6893,6500,-393
2018,Lake Geneva,SECTOR 3 SERVICES ,Lowest management,7381,7058,7651,593
2018,Lake Geneva,Wholesale and retail trade,Lowest management,6449,6418,6498,80
2018,Lake Geneva,Transportation and storage,Lowest management,7401,6268,7597,1329
2018,Lake Geneva,Hotels and restaurants,Lowest management,4681,4428,4747,319
2018,Lake Geneva,Information and communication,Lowest management,9106,7408,9424,2016
2018,Lake Geneva,Financial and insurance services,Lowest management,9286,8590,9910,1320
2018,Lake Geneva,Professional services,Lowest management,8463,7850,8867,1017
2018,Lake Geneva,Other business services,Lowest management,6266,5763,6462,699
2018,Lake Geneva,Health and social work,Lowest management,6877,6815,6919,104
2018,Lake Geneva,Arts and recreation,Lowest management,7544,7846,7295,-551
2018,Lake Geneva,Other service activities,Lowest management,6992,6847,7381,534
2018,Lake Geneva,TOTAL,No management,5999,6036,5973,-63
2018,Lake Geneva,SECTOR 2 PRODUCTION,No management,6046,5716,6100,384
2018,Lake Geneva,Mining and quarrying,No management,5827,0,5872,5872
2018,Lake Geneva,Manufacturing of Goods,No management,6198,5600,6420,820
2018,Lake Geneva,Waste disposal,No management,5950,5716,5984,268
2018,Lake Geneva,Construction ,No management,5800,5885,5800,-85
2018,Lake Geneva,SECTOR 3 SERVICES ,No management,5982,6077,5892,-185
2018,Lake Geneva,Wholesale and retail trade,No management,5007,4755,5248,493
2018,Lake Geneva,Transportation and storage,No management,5416,5493,5412,-81
2018,Lake Geneva,Hotels and restaurants,No management,4204,4108,4275,167
2018,Lake Geneva,Information and communication,No management,7357,6488,7667,1179
2018,Lake Geneva,Financial and insurance services,No management,6944,6648,7642,994
2018,Lake Geneva,Professional services,No management,6667,6500,6886,386
2018,Lake Geneva,Other business services,No management,5100,4805,5193,388
2018,Lake Geneva,Health and social work,No management,6331,6248,6591,343
2018,Lake Geneva,Arts and recreation,No management,6916,6916,6917,1
2018,Lake Geneva,Other service activities,No management,5401,5107,6000,893
2016,Lake Geneva,TOTAL,Total ,6591,6329,6770,441
2016,Lake Geneva,SECTOR 2 PRODUCTION,Total ,6500,6083,6583,500
2016,Lake Geneva,Mining and quarrying,Total ,6412,0,6346,6346
2016,Lake Geneva,Manufacturing of Goods,Total ,6693,6000,6952,952
2016,Lake Geneva,Waste disposal,Total ,5907,5936,5896,-40
2016,Lake Geneva,Construction ,Total ,6205,5983,6225,242
2016,Lake Geneva,SECTOR 3 SERVICES ,Total ,6626,6367,6918,551
2016,Lake Geneva,Wholesale and retail trade,Total ,5500,5000,5850,850
2016,Lake Geneva,Transportation and storage,Total ,5963,5843,5994,151
2016,Lake Geneva,Hotels and restaurants,Total ,4237,4051,4410,359
2016,Lake Geneva,Information and communication,Total ,8451,7156,8853,1697
2016,Lake Geneva,Financial and insurance services,Total ,9812,8086,11313,3227
2016,Lake Geneva,Professional services,Total ,7746,7065,8339,1274
2016,Lake Geneva,Other business services,Total ,5400,5101,5477,376
2016,Lake Geneva,Health and social work,Total ,6638,6433,7319,886
2016,Lake Geneva,Arts and recreation,Total ,6866,6645,7040,395
2016,Lake Geneva,Other service activities,Total ,5999,5200,7223,2023
2016,Lake Geneva,TOTAL,T/U/M Management,11048,9617,11603,1986
2016,Lake Geneva,SECTOR 2 PRODUCTION,T/U/M Management,10113,9783,10113,330
2016,Lake Geneva,Mining and quarrying,T/U/M Management,0,0,0,0
2016,Lake Geneva,Manufacturing of Goods,T/U/M Management,10883,10847,10909,62
2016,Lake Geneva,Waste disposal,T/U/M Management,9193,0,9423,9423
2016,Lake Geneva,Construction ,T/U/M Management,8559,7164,8778,1614
2016,Lake Geneva,SECTOR 3 SERVICES ,T/U/M Management,11315,9614,12074,2460
2016,Lake Geneva,Wholesale and retail trade,T/U/M Management,9198,8000,9935,1935
,,,,9733,8890,10091,1201
,,,,5673,4921,6069,1148
,,,,11170,9458,11429,1971
2016,Lake Geneva,Financial and insurance services,T/U/M Management,17189,15251,17944,2693
,,,,11496,10102,11931,1829
2016,Lake Geneva,Other business services,T/U/M Management,10000,8412,10742,2330
2016,Lake Geneva,Health and social work,T/U/M Management,11360,9819,12605,2786
,,,,9993,9121,10552,1431
2016,Lake Geneva,Other service activities,T/U/M Management,9959,8679,10805,2126
2016,Lake Geneva,TOTAL,Lower management,8831,8193,9192,999
2016,Lake Geneva,SECTOR 2 PRODUCTION,Lower management,8947,8588,9044,456
2016,Lake Geneva,Mining and quarrying,Lower management,0,0,0,0
2016,Lake Geneva,Manufacturing of Goods,Lower management,9112,8954,9196,242
2016,Lake Geneva,Waste disposal,Lower management,7557,0,7822,7822
2016,Lake Geneva,Construction ,Lower management,7192,6645,7222,577
2016,Lake Geneva,SECTOR 3 SERVICES ,Lower management,8798,8145,9225,1080
2016,Lake Geneva,Wholesale and retail trade,Lower management,7840,7581,7958,377
,,,,8425,7798,8800,1002
2016,Lake Geneva,Hotels and restaurants,Lower management,5184,4877,5465,588
2016,Lake Geneva,Information and communication,Lower management,9885,8701,10170,1469
2016,Lake Geneva,Financial and insurance services,Lower management,11551,10947,11835,888
,,,,8997,8336,9225,889
,,,,7731,7731,7760,29
2016,Lake Geneva,Health and social work,Lower management,8912,8359,9632,1273
,,,,8748,8304,9344,1040
,,,,7792,7515,8402,887
2016,Lake Geneva,TOTAL,Lowest management,7285,7000,7414,414
2016,Lake Geneva,SECTOR 2 PRODUCTION,Lowest management,7161,7202,7145,-57
2016,Lake Geneva,Mining and quarrying,Lowest management,0,0,0,0
2016,Lake Geneva,Manufacturing of Goods,Lowest management,7522,7383,7539,156
,,,,6258,0,6258,6258
,,,,6777,6499,6786,287
2016,Lake Geneva,SECTOR 3 SERVICES ,Lowest management,7333,6985,7535,550
2016,Lake Geneva,Wholesale and retail trade,Lowest management,6218,6000,6302,302
,,,,7389,6733,7510,777
2016,Lake Geneva,Hotels and restaurants,Lowest management,4828,4398,4962,564
2016,Lake Geneva,Information and communication,Lowest management,8439,7501,8823,1322
2016,Lake Geneva,Financial and insurance services,Lowest management,9451,8815,9988,1173
2016,Lake Geneva,Professional services,Lowest management,7802,7593,8052,459
2016,Lake Geneva,Other business services,Lowest management,6804,6630,6818,188
2016,Lake Geneva,Health and social work,Lowest management,7148,6898,7588,690
,,,,7500,7365,7807,442
,,,,6757,6681,7003,322
2016,Lake Geneva,TOTAL,No management,6000,5939,6047,108
2016,Lake Geneva,SECTOR 2 PRODUCTION,No management,6140,5744,6216,472
,,,,5989,0,5955,5955
2016,Lake Geneva,Manufacturing of Goods,No management,6233,5628,6450,822
2016,Lake Geneva,Waste disposal,No management,5628,5785,5620,-165
2016,Lake Geneva,Construction ,No management,5954,5795,5968,173
2016,Lake Geneva,SECTOR 3 SERVICES ,No management,5945,5965,5918,-47
2016,Lake Geneva,Wholesale and retail trade,No management,4893,4616,5158,542
2016,Lake Geneva,Transportation and storage,No management,5422,5469,5414,-55
2016,Lake Geneva,Hotels and restaurants,No management,4053,3946,4151,205
2016,Lake Geneva,Information and communication,No management,7348,6500,7710,1210
2016,Lake Geneva,Financial and insurance services,No management,7126,6696,7771,1075
2016,Lake Geneva,Professional services,No management,6550,6452,6689,237
2016,Lake Geneva,Other business services,No management,5189,4854,5279,425
2016,Lake Geneva,Health and social work,No management,6348,6222,6680,458
2016,Lake Geneva,Arts and recreation,No management,5912,6200,5750,-450
2016,Lake Geneva,Other service activities,No management,4693,4299,5952,1653
2014,Lake Geneva,TOTAL,Total ,6497,6189,6682,493
2014,Lake Geneva,SECTOR 2 PRODUCTION,Total ,6402,5882,6500,618
,,,,5946,0,6067,6067
2014,Lake Geneva,Manufacturing of Goods,Total ,6542,5781,6806,1025
2014,Lake Geneva,Waste disposal,Total ,5778,5579,5779,200
2014,Lake Geneva,Construction ,Total ,6104,5843,6113,270
2014,Lake Geneva,SECTOR 3 SERVICES ,Total ,6530,6239,6836,597
2014,Lake Geneva,Wholesale and retail trade,Total ,5374,4820,5733,913
2014,Lake Geneva,Transportation and storage,Total ,5894,5502,5977,475
2014,Lake Geneva,Hotels and restaurants,Total ,4198,3932,4430,498
2014,Lake Geneva,Information and communication,Total ,8586,7284,8972,1688
2014,Lake Geneva,Financial and insurance services,Total ,10000,8333,11472,3139
2014,Lake Geneva,Professional services,Total ,7899,7086,8632,1546
2014,Lake Geneva,Other business services,Total ,5046,4706,5180,474
2014,Lake Geneva,Health and social work,Total ,6664,6398,7358,960
2014,Lake Geneva,Arts and recreation,Total ,6675,7119,6499,-620
2014,Lake Geneva,Other service activities,Total ,6326,5563,7627,2064
2014,Lake Geneva,TOTAL,T/U/M Management,10833,9559,11370,1811
,,,,10103,10008,10103,95
,,,,0,0,0,0
2014,Lake Geneva,Manufacturing of Goods,T/U/M Management,10738,10821,10718,-103
,,,,10636,0,10726,10726
,,,,8259,0,8410,8410
2014,Lake Geneva,SECTOR 3 SERVICES ,T/U/M Management,10992,9524,11768,2244
,,,,8799,8000,9046,1046
,,,,8667,7173,8836,1663
,,,,6588,5777,6667,890
,,,,11655,9493,11917,2424
2014,Lake Geneva,Financial and insurance services,T/U/M Management,16635,14016,17471,3455
,,,,11991,10313,12305,1992
2014,Lake Geneva,Other business services,T/U/M Management,8818,8259,8884,625
2014,Lake Geneva,Health and social work,T/U/M Management,10857,9583,12492,2909
,,,,8883,9999,8560,-1439
,,,,9317,7711,10098,2387
2014,Lake Geneva,TOTAL,Lower management,8598,8094,8911,817
2014,Lake Geneva,SECTOR 2 PRODUCTION,Lower management,8393,8096,8435,339
,,,,0,0,0,0
2014,Lake Geneva,Manufacturing of Goods,Lower management,8742,8521,8807,286
,,,,7800,0,7831,7831
,,,,7091,6627,7140,513
2014,Lake Geneva,SECTOR 3 SERVICES ,Lower management,8667,8088,9127,1039
,,,,8000,7714,8019,305
,,,,7827,0,8340,8340
,,,,5267,4930,5571,641
2014,Lake Geneva,Information and communication,Lower management,9922,8837,10148,1311
2014,Lake Geneva,Financial and insurance services,Lower management,11550,10833,12090,1257
,,,,9219,8692,9555,863
,,,,7040,6602,7100,498
2014,Lake Geneva,Health and social work,Lower management,8417,7823,9231,1408
,,,,8576,8300,9074,774
,,,,7896,7599,8750,1151
2014,Lake Geneva,TOTAL,Lowest management,6949,6630,7119,489
2014,Lake Geneva,SECTOR 2 PRODUCTION,Lowest management,6824,6770,6840,70
,,,,0,0,0,0
2014,Lake Geneva,Manufacturing of Goods,Lowest management,7040,6826,7109,283
,,,,6644,0,6832,6832
2014,Lake Geneva,Construction ,Lowest management,6727,6506,6728,222
2014,Lake Geneva,SECTOR 3 SERVICES ,Lowest management,7009,6626,7377,751
2014,Lake Geneva,Wholesale and retail trade,Lowest management,6110,5860,6249,389
2014,Lake Geneva,Transportation and storage,Lowest management,7197,6483,7384,901
2014,Lake Geneva,Hotels and restaurants,Lowest management,4850,4458,4951,493
2014,Lake Geneva,Information and communication,Lowest management,8566,8234,8720,486
2014,Lake Geneva,Financial and insurance services,Lowest management,9181,8751,9595,844
,,,,8255,7819,8483,664
2014,Lake Geneva,Other business services,Lowest management,5971,6030,5917,-113
2014,Lake Geneva,Health and social work,Lowest management,6679,6386,7564,1178
,,,,6400,7119,5873,-1246
,,,,6209,5779,7126,1347
2014,Lake Geneva,TOTAL,No management,5899,5796,5960,164
2014,Lake Geneva,SECTOR 2 PRODUCTION,No management,6067,5632,6156,524
,,,,5736,0,5770,5770
2014,Lake Geneva,Manufacturing of Goods,No management,6133,5549,6376,827
,,,,5469,5226,5493,267
2014,Lake Geneva,Construction ,No management,5881,5503,5902,399
2014,Lake Geneva,SECTOR 3 SERVICES ,No management,5794,5833,5756,-77
2014,Lake Geneva,Wholesale and retail trade,No management,4762,4515,5007,492
2014,Lake Geneva,Transportation and storage,No management,5462,5264,5523,259
2014,Lake Geneva,Hotels and restaurants,No management,3954,3817,4099,282
2014,Lake Geneva,Information and communication,No management,7246,6329,7594,1265
2014,Lake Geneva,Financial and insurance services,No management,7312,6988,7846,858
2014,Lake Geneva,Professional services,No management,6482,6360,6616,256
2014,Lake Geneva,Other business services,No management,4836,4455,4932,477
2014,Lake Geneva,Health and social work,No management,6360,6190,6830,640
2014,Lake Geneva,Arts and recreation,No management,6094,6454,5857,-597
,,,,4942,4387,5953,1566
2012,Lake Geneva,TOTAL,Total ,6558,6151,6855,704
2012,Lake Geneva,SECTOR 2 PRODUCTION,Total ,6482,5939,6597,658
,,,,5945,0,5975,5975
2012,Lake Geneva,Manufacturing of Goods,Total ,6763,5906,7114,1208
2012,Lake Geneva,Waste disposal,Total ,5907,5596,5925,329
2012,Lake Geneva,Construction ,Total ,6151,5804,6172,368
2012,Lake Geneva,SECTOR 3 SERVICES ,Total ,6594,6187,7083,896
2012,Lake Geneva,Wholesale and retail trade,Total ,5365,4698,5822,1124
,,,,5493,5508,5483,-25
2012,Lake Geneva,Hotels and restaurants,Total ,4089,3889,4334,445
2012,Lake Geneva,Information and communication,Total ,8115,6899,8500,1601
2012,Lake Geneva,Financial and insurance services,Total ,9614,7858,11079,3221
2012,Lake Geneva,Professional services,Total ,7729,6695,8823,2128
2012,Lake Geneva,Other business services,Total ,5497,5092,5604,512
2012,Lake Geneva,Health and social work,Total ,6528,6284,7216,932
2012,Lake Geneva,Arts and recreation,Total ,6980,6984,6980,-4
2012,Lake Geneva,Other service activities,Total ,6401,5566,7775,2209
2012,Lake Geneva,TOTAL,T/U/M Management,10958,9326,11666,2340
2012,Lake Geneva,SECTOR 2 PRODUCTION,T/U/M Management,9412,8068,9604,1536
,,,,0,0,0,0
2012,Lake Geneva,Manufacturing of Goods,T/U/M Management,9983,9132,10058,926
,,,,9905,0,10280,10280
,,,,8556,6717,8672,1955
2012,Lake Geneva,SECTOR 3 SERVICES ,T/U/M Management,11300,9444,12209,2765
2012,Lake Geneva,Wholesale and retail trade,T/U/M Management,9750,8500,10417,1917
,,,,9774,7697,10359,2662
2012,Lake Geneva,Hotels and restaurants,T/U/M Management,5444,4952,5674,722
2012,Lake Geneva,Information and communication,T/U/M Management,11098,8883,11584,2701
2012,Lake Geneva,Financial and insurance services,T/U/M Management,16915,14917,17557,2640
,,,,12752,11333,13088,1755
,,,,10092,8751,10817,2066
,,,,10839,9864,12023,2159
,,,,8900,7800,10196,2396
,,,,8504,7691,9245,1554
2012,Lake Geneva,TOTAL,Lower management,9108,8510,9467,957
2012,Lake Geneva,SECTOR 2 PRODUCTION,Lower management,8708,8048,8874,826
,,,,0,0,0,0
2012,Lake Geneva,Manufacturing of Goods,Lower management,9281,8812,9364,552
,,,,0,0,0,0
,,,,7433,6521,7587,1066
2012,Lake Geneva,SECTOR 3 SERVICES ,Lower management,9177,8549,9687,1138
,,,,8050,7880,8223,343
,,,,7192,6467,7384,917
,,,,4743,4068,5107,1039
2012,Lake Geneva,Information and communication,Lower management,9860,9129,9967,838
2012,Lake Geneva,Financial and insurance services,Lower management,11527,10661,12083,1422
2012,Lake Geneva,Professional services,Lower management,8667,8333,9105,772
2012,Lake Geneva,Other business services,Lower management,8075,7692,8220,528
2012,Lake Geneva,Health and social work,Lower management,8928,8594,9467,873
,,,,8983,8526,9544,1018
2012,Lake Geneva,Other service activities,Lower management,8208,7764,9266,1502
2012,Lake Geneva,TOTAL,Lowest management,7101,6844,7217,373
2012,Lake Geneva,SECTOR 2 PRODUCTION,Lowest management,6824,6453,6859,406
,,,,0,0,0,0
2012,Lake Geneva,Manufacturing of Goods,Lowest management,6902,6346,7013,667
,,,,6845,0,7053,7053
,,,,6641,6455,6666,211
2012,Lake Geneva,SECTOR 3 SERVICES ,Lowest management,7251,6895,7539,644
2012,Lake Geneva,Wholesale and retail trade,Lowest management,5864,5574,6036,462
2012,Lake Geneva,Transportation and storage,Lowest management,6039,5612,6169,557
2012,Lake Geneva,Hotels and restaurants,Lowest management,4594,4264,4794,530
2012,Lake Geneva,Information and communication,Lowest management,8335,7447,8500,1053
2012,Lake Geneva,Financial and insurance services,Lowest management,9662,9008,10049,1041
2012,Lake Geneva,Professional services,Lowest management,7222,6658,7539,881
,,,,6357,6137,6363,226
2012,Lake Geneva,Health and social work,Lowest management,7365,7247,7646,399
,,,,7101,7518,6740,-778
,,,,6528,5893,7555,1662
2012,Lake Geneva,TOTAL,No management,5912,5722,6041,319
2012,Lake Geneva,SECTOR 2 PRODUCTION,No management,6158,5717,6244,527
,,,,5458,0,5669,5669
2012,Lake Geneva,Manufacturing of Goods,No management,6422,5712,6750,1038
,,,,5386,4622,5393,771
2012,Lake Geneva,Construction ,No management,5859,5427,5881,454
2012,Lake Geneva,SECTOR 3 SERVICES ,No management,5781,5723,5843,120
2012,Lake Geneva,Wholesale and retail trade,No management,4706,4362,5068,706
,,,,5150,5282,5143,-139
2012,Lake Geneva,Hotels and restaurants,No management,3919,3792,4042,250
2012,Lake Geneva,Information and communication,No management,6864,6280,7038,758
2012,Lake Geneva,Financial and insurance services,No management,7066,6615,7629,1014
2012,Lake Geneva,Professional services,No management,5965,5830,6242,412
2012,Lake Geneva,Other business services,No management,5113,4684,5243,559
2012,Lake Geneva,Health and social work,No management,6114,6005,6547,542
,,,,6212,6392,6055,-337
,,,,5274,4436,5985,1549
2020,Midlands,TOTAL,Total ,6600,6112,6923,811
2020,Midlands,SECTOR 2 PRODUCTION,Total ,6301,5490,6490,1000
,,,,6333,0,6404,6404
2020,Midlands,Manufacturing of Goods,Total ,6233,5390,6571,1181
2020,Midlands,Waste disposal,Total ,6478,6400,6500,100
2020,Midlands,Construction ,Total ,6280,6065,6286,221
2020,Midlands,SECTOR 3 SERVICES ,Total ,6790,6258,7353,1095
2020,Midlands,Wholesale and retail trade,Total ,5549,5037,6038,1001
2020,Midlands,Transportation and storage,Total ,6655,6159,6842,683
2020,Midlands,Hotels and restaurants,Total ,4444,4382,4586,204
2020,Midlands,Information and communication,Total ,8766,7040,9424,2384
2020,Midlands,Financial and insurance services,Total ,8070,6986,9627,2641
2020,Midlands,Professional services,Total ,7584,6655,8331,1676
2020,Midlands,Other business services,Total ,5783,5058,6021,963
2020,Midlands,Health and social work,Total ,6255,6086,6931,845
2020,Midlands,Arts and recreation,Total ,6182,5813,6497,684
2020,Midlands,Other service activities,Total ,6705,6290,7333,1043
2020,Midlands,TOTAL,T/U/M Management,9949,8590,10505,1915
2020,Midlands,SECTOR 2 PRODUCTION,T/U/M Management,9231,8218,9367,1149
,,,,0,0,0,0
2020,Midlands,Manufacturing of Goods,T/U/M Management,9554,8284,9722,1438
,,,,9498,0,9730,9730
2020,Midlands,Construction ,T/U/M Management,8280,7192,8432,1240
2020,Midlands,SECTOR 3 SERVICES ,T/U/M Management,10315,8665,11107,2442
2020,Midlands,Wholesale and retail trade,T/U/M Management,8109,6627,8728,2101
2020,Midlands,Transportation and storage,T/U/M Management,11024,9082,11230,2148
2020,Midlands,Hotels and restaurants,T/U/M Management,5467,5068,5798,730
2020,Midlands,Information and communication,T/U/M Management,12743,11228,12946,1718
2020,Midlands,Financial and insurance services,T/U/M Management,12296,10831,12764,1933
2020,Midlands,Professional services,T/U/M Management,10917,9489,11203,1714
2020,Midlands,Other business services,T/U/M Management,8002,7427,8340,913
2020,Midlands,Health and social work,T/U/M Management,9416,8595,11111,2516
2020,Midlands,Arts and recreation,T/U/M Management,8133,7581,8517,936
2020,Midlands,Other service activities,T/U/M Management,8808,8305,9304,999
2020,Midlands,TOTAL,Lower management,8263,7717,8595,878
2020,Midlands,SECTOR 2 PRODUCTION,Lower management,7886,7273,7999,726
,,,,0,0,0,0
2020,Midlands,Manufacturing of Goods,Lower management,8080,7290,8218,928
,,,,0,0,0,0
2020,Midlands,Construction ,Lower management,7448,6694,7457,763
2020,Midlands,SECTOR 3 SERVICES ,Lower management,8470,7797,9127,1330
2020,Midlands,Wholesale and retail trade,Lower management,6895,6421,7190,769
2020,Midlands,Transportation and storage,Lower management,8423,7458,8606,1148
2020,Midlands,Hotels and restaurants,Lower management,5158,4932,5375,443
2020,Midlands,Information and communication,Lower management,9723,8000,10185,2185
2020,Midlands,Financial and insurance services,Lower management,9693,8700,10283,1583
2020,Midlands,Professional services,Lower management,8335,7623,8614,991
2020,Midlands,Other business services,Lower management,7040,6665,7233,568
2020,Midlands,Health and social work,Lower management,7905,7562,8346,784
2020,Midlands,Arts and recreation,Lower management,6983,6552,7416,864
2020,Midlands,Other service activities,Lower management,7542,7113,8033,920
2020,Midlands,TOTAL,Lowest management,7232,6749,7519,770
2020,Midlands,SECTOR 2 PRODUCTION,Lowest management,6860,6328,6954,626
,,,,0,0,0,0
2020,Midlands,Manufacturing of Goods,Lowest management,6882,6309,7040,731
,,,,6910,0,6830,6830
2020,Midlands,Construction ,Lowest management,6687,6226,6708,482
2020,Midlands,SECTOR 3 SERVICES ,Lowest management,7461,6814,8038,1224
2020,Midlands,Wholesale and retail trade,Lowest management,5935,5531,6340,809
2020,Midlands,Transportation and storage,Lowest management,10504,10170,10574,404
2020,Midlands,Hotels and restaurants,Lowest management,4763,4701,4889,188
2020,Midlands,Information and communication,Lowest management,8832,7338,9331,1993
2020,Midlands,Financial and insurance services,Lowest management,7802,7616,8091,475
2020,Midlands,Professional services,Lowest management,7455,6588,7935,1347
2020,Midlands,Other business services,Lowest management,6061,5856,6061,205
2020,Midlands,Health and social work,Lowest management,6808,6738,7029,291
2020,Midlands,Arts and recreation,Lowest management,6396,5831,6760,929
2020,Midlands,Other service activities,Lowest management,7148,6897,7615,718
2020,Midlands,TOTAL,No management,6129,5814,6329,515
2020,Midlands,SECTOR 2 PRODUCTION,No management,5941,5283,6098,815
,,,,6129,0,6160,6160
2020,Midlands,Manufacturing of Goods,No management,5826,5185,6109,924
2020,Midlands,Waste disposal,No management,6029,6192,6014,-178
2020,Midlands,Construction ,No management,6002,5859,6011,152
2020,Midlands,SECTOR 3 SERVICES ,No management,6258,5959,6602,643
2020,Midlands,Wholesale and retail trade,No management,5162,4855,5483,628
2020,Midlands,Transportation and storage,No management,6382,6059,6543,484
2020,Midlands,Hotels and restaurants,No management,4294,4296,4290,-6
2020,Midlands,Information and communication,No management,8022,6814,8638,1824
2020,Midlands,Financial and insurance services,No management,7036,6629,8004,1375
2020,Midlands,Professional services,No management,6594,6229,7050,821
2020,Midlands,Other business services,No management,5540,4833,5820,987
2020,Midlands,Health and social work,No management,5903,5829,6238,409
2020,Midlands,Arts and recreation,No management,5702,5509,5842,333
2020,Midlands,Other service activities,No management,6116,5899,6552,653
2018,Midlands,TOTAL,Total ,6511,5994,6864,870
2018,Midlands,SECTOR 2 PRODUCTION,Total ,6253,5429,6452,1023
,,,,6312,0,6330,6330
2018,Midlands,Manufacturing of Goods,Total ,6207,5324,6511,1187
2018,Midlands,Waste disposal,Total ,6108,5981,6115,134
2018,Midlands,Construction ,Total ,6200,5998,6242,244
2018,Midlands,SECTOR 3 SERVICES ,Total ,6679,6118,7251,1133
2018,Midlands,Wholesale and retail trade,Total ,5547,4937,6127,1190
2018,Midlands,Transportation and storage,Total ,6582,6031,6819,788
2018,Midlands,Hotels and restaurants,Total ,4393,4300,4540,240
2018,Midlands,Information and communication,Total ,8616,6939,9316,2377
2018,Midlands,Financial and insurance services,Total ,7908,6707,9639,2932
2018,Midlands,Professional services,Total ,7307,6424,8211,1787
2018,Midlands,Other business services,Total ,5483,4878,5683,805
2018,Midlands,Health and social work,Total ,6189,5985,6923,938
2018,Midlands,Arts and recreation,Total ,6175,5671,6657,986
2018,Midlands,Other service activities,Total ,6629,6097,7454,1357
2018,Midlands,TOTAL,T/U/M Management,9848,8125,10433,2308
2018,Midlands,SECTOR 2 PRODUCTION,T/U/M Management,9429,8555,9557,1002
,,,,8177,0,0,0
2018,Midlands,Manufacturing of Goods,T/U/M Management,9810,9060,9933,873
,,,,9475,0,9972,9972
2018,Midlands,Construction ,T/U/M Management,8295,4545,8352,3807
2018,Midlands,SECTOR 3 SERVICES ,T/U/M Management,10095,8088,10978,2890
2018,Midlands,Wholesale and retail trade,T/U/M Management,8412,6190,9210,3020
2018,Midlands,Transportation and storage,T/U/M Management,11485,9778,11673,1895
2018,Midlands,Hotels and restaurants,T/U/M Management,5365,4952,5879,927
2018,Midlands,Information and communication,T/U/M Management,13029,11968,13190,1222
2018,Midlands,Financial and insurance services,T/U/M Management,12020,10564,12381,1817
2018,Midlands,Professional services,T/U/M Management,10833,8282,11486,3204
2018,Midlands,Other business services,T/U/M Management,7892,7059,8066,1007
2018,Midlands,Health and social work,T/U/M Management,8679,7824,10317,2493
2018,Midlands,Arts and recreation,T/U/M Management,8254,7222,8850,1628
2018,Midlands,Other service activities,T/U/M Management,9215,8565,9811,1246
2018,Midlands,TOTAL,Lower management,8099,7345,8443,1098
2018,Midlands,SECTOR 2 PRODUCTION,Lower management,7853,7598,7900,302
,,,,6882,0,6859,6859
2018,Midlands,Manufacturing of Goods,Lower management,8025,7434,8145,711
,,,,6641,0,0,0
2018,Midlands,Construction ,Lower management,7416,8011,7329,-682
2018,Midlands,SECTOR 3 SERVICES ,Lower management,8232,7300,8875,1575
2018,Midlands,Wholesale and retail trade,Lower management,7062,6098,7329,1231
2018,Midlands,Transportation and storage,Lower management,8212,6100,8425,2325
2018,Midlands,Hotels and restaurants,Lower management,5038,4770,5334,564
2018,Midlands,Information and communication,Lower management,9079,7131,9670,2539
2018,Midlands,Financial and insurance services,Lower management,9848,8831,10325,1494
2018,Midlands,Professional services,Lower management,8252,6879,8930,2051
2018,Midlands,Other business services,Lower management,6747,6240,6893,653
2018,Midlands,Health and social work,Lower management,7353,6826,8229,1403
2018,Midlands,Arts and recreation,Lower management,7143,6139,7535,1396
2018,Midlands,Other service activities,Lower management,7963,7366,8611,1245
2018,Midlands,TOTAL,Lowest management,6962,6564,7179,615
2018,Midlands,SECTOR 2 PRODUCTION,Lowest management,6559,6066,6641,575
,,,,6020,0,6034,6034
2018,Midlands,Manufacturing of Goods,Lowest management,6683,6130,6872,742
,,,,6923,0,6923,6923
2018,Midlands,Construction ,Lowest management,6296,5811,6366,555
2018,Midlands,SECTOR 3 SERVICES ,Lowest management,7266,6697,7740,1043
2018,Midlands,Wholesale and retail trade,Lowest management,5847,5366,6248,882
2018,Midlands,Transportation and storage,Lowest management,8916,7836,9152,1316
2018,Midlands,Hotels and restaurants,Lowest management,4776,4487,4930,443
2018,Midlands,Information and communication,Lowest management,8305,7398,8598,1200
2018,Midlands,Financial and insurance services,Lowest management,8229,7663,8866,1203
2018,Midlands,Professional services,Lowest management,7290,6871,7760,889
2018,Midlands,Other business services,Lowest management,5600,5525,5608,83
2018,Midlands,Health and social work,Lowest management,6729,6618,7053,435
2018,Midlands,Arts and recreation,Lowest management,6488,6190,6676,486
2018,Midlands,Other service activities,Lowest management,6637,6396,7042,646
2018,Midlands,TOTAL,No management,6085,5744,6293,549
2018,Midlands,SECTOR 2 PRODUCTION,No management,5881,5210,6050,840
,,,,6200,0,6210,6210
2018,Midlands,Manufacturing of Goods,No management,5805,5141,6078,937
2018,Midlands,Waste disposal,No management,5622,5748,5613,-135
2018,Midlands,Construction ,No management,5927,5795,5935,140
2018,Midlands,SECTOR 3 SERVICES ,No management,6205,5896,6564,668
2018,Midlands,Wholesale and retail trade,No management,5170,4778,5630,852
2018,Midlands,Transportation and storage,No management,6246,5954,6460,506
2018,Midlands,Hotels and restaurants,No management,4237,4197,4272,75
2018,Midlands,Information and communication,No management,7847,6729,8489,1760
2018,Midlands,Financial and insurance services,No management,6792,6406,7936,1530
2018,Midlands,Professional services,No management,6495,6041,6973,932
2018,Midlands,Other business services,No management,5329,4735,5548,813
2018,Midlands,Health and social work,No management,5850,5772,6180,408
2018,Midlands,Arts and recreation,No management,5693,5275,5992,717
2018,Midlands,Other service activities,No management,5947,5584,6500,916
2016,Midlands,TOTAL,Total ,6426,5907,6785,878
2016,Midlands,SECTOR 2 PRODUCTION,Total ,6125,5355,6321,966
,,,,6357,0,6386,6386
2016,Midlands,Manufacturing of Goods,Total ,6127,5275,6452,1177
,,,,6240,6325,6229,-96
2016,Midlands,Construction ,Total ,6017,5736,6039,303
2016,Midlands,SECTOR 3 SERVICES ,Total ,6638,6048,7281,1233
2016,Midlands,Wholesale and retail trade,Total ,5401,4781,6010,1229
2016,Midlands,Transportation and storage,Total ,6506,6027,6753,726
2016,Midlands,Hotels and restaurants,Total ,4331,4272,4460,188
2016,Midlands,Information and communication,Total ,8750,7120,9439,2319
2016,Midlands,Financial and insurance services,Total ,7771,6634,9414,2780
2016,Midlands,Professional services,Total ,7341,6423,8227,1804
2016,Midlands,Other business services,Total ,5606,4925,5822,897
2016,Midlands,Health and social work,Total ,6149,5971,6831,860
2016,Midlands,Arts and recreation,Total ,6116,5742,6381,639
2016,Midlands,Other service activities,Total ,6384,5896,7004,1108
2016,Midlands,TOTAL,T/U/M Management,9620,8193,10223,2030
2016,Midlands,SECTOR 2 PRODUCTION,T/U/M Management,9335,8130,9490,1360
,,,,0,0,0,0
2016,Midlands,Manufacturing of Goods,T/U/M Management,9754,8661,10000,1339
,,,,8894,0,9478,9478
2016,Midlands,Construction ,T/U/M Management,7968,6943,8185,1242
2016,Midlands,SECTOR 3 SERVICES ,T/U/M Management,9812,8193,10748,2555
2016,Midlands,Wholesale and retail trade,T/U/M Management,8360,6667,8824,2157
,,,,11468,9624,11635,2011
,,,,5860,5462,6260,798
,,,,10715,7879,11043,3164
2016,Midlands,Financial and insurance services,T/U/M Management,11981,10043,12354,2311
2016,Midlands,Professional services,T/U/M Management,10753,8768,11369,2601
,,,,7263,6599,7402,803
2016,Midlands,Health and social work,T/U/M Management,8613,8121,10068,1947
,,,,8707,8285,9415,1130
,,,,9149,8850,9562,712
2016,Midlands,TOTAL,Lower management,7621,6951,7964,1013
,,,,7354,6295,7479,1184
,,,,6890,0,6860,6860
,,,,7297,6291,7446,1155
,,,,6860,0,0,0
2016,Midlands,Construction ,Lower management,7274,5957,7311,1354
2016,Midlands,SECTOR 3 SERVICES ,Lower management,7841,7052,8568,1516
2016,Midlands,Wholesale and retail trade,Lower management,6525,5642,7004,1362
,,,,7689,6323,7969,1646
,,,,5137,4937,5158,221
2016,Midlands,Information and communication,Lower management,8640,7867,8982,1115
2016,Midlands,Financial and insurance services,Lower management,9716,8050,10380,2330
2016,Midlands,Professional services,Lower management,8438,7467,8970,1503
,,,,5983,5744,6010,266
2016,Midlands,Health and social work,Lower management,7221,6943,7785,842
,,,,7606,7206,8187,981
2016,Midlands,Other service activities,Lower management,7786,7359,8592,1233
2016,Midlands,TOTAL,Lowest management,6899,6359,7153,794
2016,Midlands,SECTOR 2 PRODUCTION,Lowest management,6626,5978,6743,765
,,,,5907,0,5915,5915
2016,Midlands,Manufacturing of Goods,Lowest management,6643,5925,6855,930
,,,,6028,0,6028,6028
2016,Midlands,Construction ,Lowest management,6507,5703,6551,848
2016,Midlands,SECTOR 3 SERVICES ,Lowest management,7110,6430,7727,1297
2016,Midlands,Wholesale and retail trade,Lowest management,5776,5212,6187,975
,,,,8763,8075,8889,814
2016,Midlands,Hotels and restaurants,Lowest management,4782,4667,5154,487
2016,Midlands,Information and communication,Lowest management,8573,7427,8899,1472
2016,Midlands,Financial and insurance services,Lowest management,8031,7582,8559,977
,,,,6907,6565,7136,571
,,,,5535,4936,5724,788
2016,Midlands,Health and social work,Lowest management,6600,6421,6964,543
,,,,6313,6117,6499,382
,,,,6428,6137,6868,731
2016,Midlands,TOTAL,No management,5956,5546,6196,650
2016,Midlands,SECTOR 2 PRODUCTION,No management,5762,5178,5933,755
,,,,6332,0,6374,6374
2016,Midlands,Manufacturing of Goods,No management,5744,5110,6025,915
2016,Midlands,Waste disposal,No management,5778,6030,5776,-254
2016,Midlands,Construction ,No management,5739,5597,5741,144
2016,Midlands,SECTOR 3 SERVICES ,No management,6071,5672,6547,875
2016,Midlands,Wholesale and retail trade,No management,5002,4642,5522,880
2016,Midlands,Transportation and storage,No management,6189,5919,6402,483
2016,Midlands,Hotels and restaurants,No management,4183,4157,4235,78
2016,Midlands,Information and communication,No management,8628,7067,9332,2265
2016,Midlands,Financial and insurance services,No management,6795,6348,7849,1501
2016,Midlands,Professional services,No management,6340,6065,6801,736
2016,Midlands,Other business services,No management,5391,4754,5625,871
2016,Midlands,Health and social work,No management,5783,5711,6149,438
2016,Midlands,Arts and recreation,No management,5612,5402,5763,361
2016,Midlands,Other service activities,No management,5792,5477,6195,718
2014,Midlands,TOTAL,Total ,6358,5879,6677,798
2014,Midlands,SECTOR 2 PRODUCTION,Total ,6076,5241,6275,1034
,,,,6525,0,6581,6581
2014,Midlands,Manufacturing of Goods,Total ,6012,5156,6343,1187
2014,Midlands,Waste disposal,Total ,6109,6184,6102,-82
2014,Midlands,Construction ,Total ,6007,5588,6038,450
2014,Midlands,SECTOR 3 SERVICES ,Total ,6530,6031,7056,1025
2014,Midlands,Wholesale and retail trade,Total ,5238,4603,5925,1322
,,,,6448,6114,6629,515
2014,Midlands,Hotels and restaurants,Total ,4331,4232,4524,292
2014,Midlands,Information and communication,Total ,8501,6924,9233,2309
2014,Midlands,Financial and insurance services,Total ,7522,6483,9286,2803
2014,Midlands,Professional services,Total ,7267,6331,8080,1749
2014,Midlands,Other business services,Total ,5552,4795,5850,1055
2014,Midlands,Health and social work,Total ,6132,5935,6895,960
2014,Midlands,Arts and recreation,Total ,6245,5722,6697,975
2014,Midlands,Other service activities,Total ,6231,5592,7246,1654
2014,Midlands,TOTAL,T/U/M Management,9629,7959,10195,2236
2014,Midlands,SECTOR 2 PRODUCTION,T/U/M Management,9219,7829,9399,1570
,,,,0,0,0,0
2014,Midlands,Manufacturing of Goods,T/U/M Management,9539,7986,9779,1793
,,,,9542,0,9455,9455
,,,,7880,6608,7934,1326
2014,Midlands,SECTOR 3 SERVICES ,T/U/M Management,9874,8000,10688,2688
,,,,7270,5584,7977,2393
,,,,11705,10949,11766,817
,,,,5218,4978,5638,660
2014,Midlands,Information and communication,T/U/M Management,12871,11362,13020,1658
2014,Midlands,Financial and insurance services,T/U/M Management,11905,10190,12302,2112
2014,Midlands,Professional services,T/U/M Management,10615,8970,11106,2136
,,,,8157,7174,8889,1715
2014,Midlands,Health and social work,T/U/M Management,8756,7911,9975,2064
,,,,8198,7222,8726,1504
2014,Midlands,Other service activities,T/U/M Management,9274,8158,9728,1570
2014,Midlands,TOTAL,Lower management,7533,6760,7896,1136
,,,,7349,6606,7501,895
,,,,0,0,0,0
,,,,7222,6463,7320,857
,,,,7197,0,7623,7623
2014,Midlands,Construction ,Lower management,7176,6281,7252,971
2014,Midlands,SECTOR 3 SERVICES ,Lower management,7674,6819,8342,1523
2014,Midlands,Wholesale and retail trade,Lower management,6665,5633,7223,1590
,,,,7724,6333,7945,1612
2014,Midlands,Hotels and restaurants,Lower management,4950,4746,5180,434
,,,,8514,6775,9694,2919
2014,Midlands,Financial and insurance services,Lower management,8849,7584,9704,2120
2014,Midlands,Professional services,Lower management,7480,6681,8093,1412
,,,,6424,6306,6762,456
2014,Midlands,Health and social work,Lower management,7200,6745,7945,1200
,,,,7837,7340,8219,879
,,,,7584,6884,8224,1340
2014,Midlands,TOTAL,Lowest management,6892,6396,7094,698
2014,Midlands,SECTOR 2 PRODUCTION,Lowest management,6562,5713,6700,987
,,,,0,0,0,0
2014,Midlands,Manufacturing of Goods,Lowest management,6542,5619,6712,1093
,,,,7014,0,6654,6654
2014,Midlands,Construction ,Lowest management,6354,5455,6427,972
2014,Midlands,SECTOR 3 SERVICES ,Lowest management,7163,6628,7538,910
2014,Midlands,Wholesale and retail trade,Lowest management,5674,4952,6303,1351
,,,,8037,7759,8111,352
2014,Midlands,Hotels and restaurants,Lowest management,4562,4562,4707,145
2014,Midlands,Information and communication,Lowest management,8115,6688,8283,1595
2014,Midlands,Financial and insurance services,Lowest management,7463,6951,8420,1469
2014,Midlands,Professional services,Lowest management,6786,6306,7222,916
,,,,6079,5327,6183,856
2014,Midlands,Health and social work,Lowest management,6675,6541,6935,394
,,,,5991,5571,0,-5571
2014,Midlands,Other service activities,Lowest management,6498,6112,6884,772
2014,Midlands,TOTAL,No management,5937,5588,6122,534
2014,Midlands,SECTOR 2 PRODUCTION,No management,5686,5028,5861,833
,,,,6356,0,6414,6414
2014,Midlands,Manufacturing of Goods,No management,5610,4978,5891,913
,,,,5585,5864,5582,-282
2014,Midlands,Construction ,No management,5752,5392,5769,377
2014,Midlands,SECTOR 3 SERVICES ,No management,6070,5751,6366,615
2014,Midlands,Wholesale and retail trade,No management,4866,4439,5262,823
,,,,6205,6020,6307,287
2014,Midlands,Hotels and restaurants,No management,4083,4056,4101,45
2014,Midlands,Information and communication,No management,7861,6739,8522,1783
2014,Midlands,Financial and insurance services,No management,6470,6159,7175,1016
2014,Midlands,Professional services,No management,6335,6000,6717,717
2014,Midlands,Other business services,No management,5214,4628,5528,900
2014,Midlands,Health and social work,No management,5778,5710,6149,439
2014,Midlands,Arts and recreation,No management,5782,5411,6166,755
2014,Midlands,Other service activities,No management,5543,5143,6176,1033
2012,Midlands,TOTAL,Total ,6308,5658,6690,1032
2012,Midlands,SECTOR 2 PRODUCTION,Total ,6066,5145,6276,1131
,,,,6242,0,6245,6245
2012,Midlands,Manufacturing of Goods,Total ,6053,5076,6397,1321
2012,Midlands,Waste disposal,Total ,6009,5680,6043,363
2012,Midlands,Construction ,Total ,5943,5343,5975,632
2012,Midlands,SECTOR 3 SERVICES ,Total ,6473,5810,7086,1276
2012,Midlands,Wholesale and retail trade,Total ,5157,4504,5759,1255
,,,,6522,6094,6733,639
2012,Midlands,Hotels and restaurants,Total ,4256,4127,4476,349
2012,Midlands,Information and communication,Total ,8547,6895,9335,2440
2012,Midlands,Financial and insurance services,Total ,7432,6347,9214,2867
2012,Midlands,Professional services,Total ,7130,6013,8128,2115
2012,Midlands,Other business services,Total ,5414,4697,5765,1068
2012,Midlands,Health and social work,Total ,6072,5843,6879,1036
2012,Midlands,Arts and recreation,Total ,5809,5210,6392,1182
2012,Midlands,Other service activities,Total ,6088,5569,6844,1275
2012,Midlands,TOTAL,T/U/M Management,9500,7441,10166,2725
2012,Midlands,SECTOR 2 PRODUCTION,T/U/M Management,9433,7440,9630,2190
,,,,0,0,0,0
2012,Midlands,Manufacturing of Goods,T/U/M Management,9849,7794,10086,2292
,,,,8449,0,8664,8664
,,,,7973,5711,8104,2393
2012,Midlands,SECTOR 3 SERVICES ,T/U/M Management,9536,7441,10553,3112
2012,Midlands,Wholesale and retail trade,T/U/M Management,7828,6118,8417,2299
,,,,10751,8722,10863,2141
2012,Midlands,Hotels and restaurants,T/U/M Management,5162,4632,5663,1031
2012,Midlands,Information and communication,T/U/M Management,12847,10456,13071,2615
2012,Midlands,Financial and insurance services,T/U/M Management,11679,9492,12069,2577
2012,Midlands,Professional services,T/U/M Management,10735,7843,11571,3728
,,,,7663,5647,9091,3444
2012,Midlands,Health and social work,T/U/M Management,8178,7551,9562,2011
2012,Midlands,Arts and recreation,T/U/M Management,8601,7291,9208,1917
,,,,9176,7889,9763,1874
2012,Midlands,TOTAL,Lower management,7586,6750,7927,1177
2012,Midlands,SECTOR 2 PRODUCTION,Lower management,7543,6714,7651,937
,,,,0,0,0,0
2012,Midlands,Manufacturing of Goods,Lower management,7679,6717,7825,1108
,,,,7781,0,0,0
,,,,6747,5545,6807,1262
2012,Midlands,SECTOR 3 SERVICES ,Lower management,7608,6760,8330,1570
2012,Midlands,Wholesale and retail trade,Lower management,6605,5755,7040,1285
,,,,6346,5843,6452,609
2012,Midlands,Hotels and restaurants,Lower management,4905,4715,4952,237
,,,,9414,7375,9837,2462
2012,Midlands,Financial and insurance services,Lower management,8886,7530,9563,2033
2012,Midlands,Professional services,Lower management,7691,6990,8270,1280
,,,,6337,5742,6884,1142
2012,Midlands,Health and social work,Lower management,7118,6740,7864,1124
,,,,6441,5760,6917,1157
,,,,7061,6139,7760,1621
2012,Midlands,TOTAL,Lowest management,6823,6243,7051,808
2012,Midlands,SECTOR 2 PRODUCTION,Lowest management,6582,5926,6700,774
,,,,0,0,0,0
2012,Midlands,Manufacturing of Goods,Lowest management,6571,5850,6721,871
,,,,7203,0,7411,7411
2012,Midlands,Construction ,Lowest management,6416,5973,6446,473
2012,Midlands,SECTOR 3 SERVICES ,Lowest management,7031,6305,7474,1169
2012,Midlands,Wholesale and retail trade,Lowest management,5412,4691,5900,1209
,,,,8024,7670,8094,424
2012,Midlands,Hotels and restaurants,Lowest management,4455,4292,4636,344
2012,Midlands,Information and communication,Lowest management,9076,7193,9822,2629
2012,Midlands,Financial and insurance services,Lowest management,7610,7055,8182,1127
2012,Midlands,Professional services,Lowest management,6838,6024,7479,1455
,,,,5715,4998,6047,1049
2012,Midlands,Health and social work,Lowest management,6612,6473,7045,572
,,,,6275,6361,5914,-447
2012,Midlands,Other service activities,Lowest management,6416,6185,6675,490
2012,Midlands,TOTAL,No management,5812,5299,6074,775
2012,Midlands,SECTOR 2 PRODUCTION,No management,5620,4900,5804,904
,,,,6045,0,6104,6104
2012,Midlands,Manufacturing of Goods,No management,5558,4854,5842,988
2012,Midlands,Waste disposal,No management,5628,5529,5634,105
2012,Midlands,Construction ,No management,5655,5221,5687,466
2012,Midlands,SECTOR 3 SERVICES ,No management,5938,5445,6362,917
2012,Midlands,Wholesale and retail trade,No management,4756,4375,5242,867
,,,,6300,6021,6453,432
2012,Midlands,Hotels and restaurants,No management,4100,4025,4225,200
2012,Midlands,Information and communication,No management,7882,6718,8569,1851
2012,Midlands,Financial and insurance services,No management,6347,6021,7293,1272
2012,Midlands,Professional services,No management,6165,5709,6775,1066
2012,Midlands,Other business services,No management,5176,4624,5499,875
2012,Midlands,Health and social work,No management,5630,5532,6140,608
2012,Midlands,Arts and recreation,No management,5349,4890,5809,919
2012,Midlands,Other service activities,No management,5347,5088,5598,510
2020,North-West,TOTAL,Total ,6789,6395,7050,655
2020,North-West,SECTOR 2 PRODUCTION,Total ,7048,7182,7023,-159
,,,,6594,0,6417,6417
2020,North-West,Manufacturing of Goods,Total ,7540,7378,7580,202
2020,North-West,Waste disposal,Total ,6346,5960,6359,399
2020,North-West,Construction ,Total ,6213,5908,6234,326
2020,North-West,SECTOR 3 SERVICES ,Total ,6671,6297,7078,781
2020,North-West,Wholesale and retail trade,Total ,5821,5152,6379,1227
2020,North-West,Transportation and storage,Total ,5623,5511,5637,126
2020,North-West,Hotels and restaurants,Total ,4638,4543,4727,184
2020,North-West,Information and communication,Total ,8719,7186,9200,2014
2020,North-West,Financial and insurance services,Total ,9066,7502,10297,2795
2020,North-West,Professional services,Total ,8166,7313,8791,1478
2020,North-West,Other business services,Total ,5605,4995,5721,726
2020,North-West,Health and social work,Total ,6470,6253,7220,967
2020,North-West,Arts and recreation,Total ,6306,5824,6651,827
2020,North-West,Other service activities,Total ,6050,5408,6952,1544
2020,North-West,TOTAL,T/U/M Management,10968,9527,11448,1921
2020,North-West,SECTOR 2 PRODUCTION,T/U/M Management,12602,16431,11795,-4636
,,,,0,0,0,0
2020,North-West,Manufacturing of Goods,T/U/M Management,14802,17041,13731,-3310
,,,,9940,0,10109,10109
2020,North-West,Construction ,T/U/M Management,8865,7697,8920,1223
2020,North-West,SECTOR 3 SERVICES ,T/U/M Management,10294,8420,11287,2867
2020,North-West,Wholesale and retail trade,T/U/M Management,9697,7307,10635,3328
2020,North-West,Transportation and storage,T/U/M Management,9181,8584,9557,973
2020,North-West,Hotels and restaurants,T/U/M Management,5629,5159,6176,1017
2020,North-West,Information and communication,T/U/M Management,10766,8381,11538,3157
2020,North-West,Financial and insurance services,T/U/M Management,16082,11911,16976,5065
2020,North-West,Professional services,T/U/M Management,12569,12443,12668,225
2020,North-West,Other business services,T/U/M Management,7645,6465,8045,1580
2020,North-West,Health and social work,T/U/M Management,9625,8605,12129,3524
2020,North-West,Arts and recreation,T/U/M Management,7906,7027,8093,1066
2020,North-West,Other service activities,T/U/M Management,9088,8045,9860,1815
2020,North-West,TOTAL,Lower management,8929,8119,9309,1190
2020,North-West,SECTOR 2 PRODUCTION,Lower management,9282,10013,9158,-855
,,,,0,0,0,0
2020,North-West,Manufacturing of Goods,Lower management,9852,10432,9722,-710
,,,,8101,0,0,0
,,,,7205,0,7136,7136
2020,North-West,SECTOR 3 SERVICES ,Lower management,8747,7752,9410,1658
2020,North-West,Wholesale and retail trade,Lower management,7704,7281,7780,499
2020,North-West,Transportation and storage,Lower management,7957,7598,7957,359
2020,North-West,Hotels and restaurants,Lower management,5270,4979,5570,591
2020,North-West,Information and communication,Lower management,10019,9189,10314,1125
2020,North-West,Financial and insurance services,Lower management,11789,10768,12137,1369
2020,North-West,Professional services,Lower management,9692,8815,10006,1191
2020,North-West,Other business services,Lower management,6859,6986,6859,-127
2020,North-West,Health and social work,Lower management,7769,7218,9150,1932
2020,North-West,Arts and recreation,Lower management,7544,6585,7796,1211
2020,North-West,Other service activities,Lower management,7002,6479,8257,1778
2020,North-West,TOTAL,Lowest management,7557,7043,7802,759
2020,North-West,SECTOR 2 PRODUCTION,Lowest management,7303,7220,7329,109
,,,,0,0,0,0
2020,North-West,Manufacturing of Goods,Lowest management,7573,7257,7612,355
,,,,7053,0,7053,7053
,,,,6951,0,6953,6953
2020,North-West,SECTOR 3 SERVICES ,Lowest management,7707,7014,8454,1440
2020,North-West,Wholesale and retail trade,Lowest management,6265,5483,7567,2084
2020,North-West,Transportation and storage,Lowest management,6784,6436,6868,432
2020,North-West,Hotels and restaurants,Lowest management,4965,4878,5073,195
,,,,9810,0,9868,9868
2020,North-West,Financial and insurance services,Lowest management,9670,8902,10123,1221
2020,North-West,Professional services,Lowest management,8484,8254,8671,417
2020,North-West,Other business services,Lowest management,8097,7586,8382,796
2020,North-West,Health and social work,Lowest management,6956,6824,7270,446
2020,North-West,Arts and recreation,Lowest management,6197,5833,6501,668
2020,North-West,Other service activities,Lowest management,6473,6177,6714,537
2020,North-West,TOTAL,No management,6195,6030,6296,266
2020,North-West,SECTOR 2 PRODUCTION,No management,6385,6242,6401,159
,,,,6348,0,6174,6174
2020,North-West,Manufacturing of Goods,No management,6645,6290,6723,433
2020,North-West,Waste disposal,No management,5936,5415,5959,544
2020,North-West,Construction ,No management,5931,5761,5957,196
2020,North-West,SECTOR 3 SERVICES ,No management,6103,6005,6203,198
2020,North-West,Wholesale and retail trade,No management,5307,4888,5775,887
2020,North-West,Transportation and storage,No management,5433,5402,5445,43
2020,North-West,Hotels and restaurants,No management,4437,4381,4480,99
2020,North-West,Information and communication,No management,8072,6917,8591,1674
2020,North-West,Financial and insurance services,No management,7279,6873,7882,1009
2020,North-West,Professional services,No management,7040,6706,7317,611
2020,North-West,Other business services,No management,5333,4737,5499,762
2020,North-West,Health and social work,No management,6177,6056,6620,564
2020,North-West,Arts and recreation,No management,5997,5715,6331,616
2020,North-West,Other service activities,No management,5291,4929,5953,1024
2018,North-West,TOTAL,Total ,6714,6251,7038,787
2018,North-West,SECTOR 2 PRODUCTION,Total ,7040,6677,7099,422
,,,,6393,0,6393,6393
2018,North-West,Manufacturing of Goods,Total ,7383,6900,7502,602
2018,North-West,Waste disposal,Total ,6163,5880,6236,356
2018,North-West,Construction ,Total ,6366,6000,6417,417
2018,North-West,SECTOR 3 SERVICES ,Total ,6570,6188,6976,788
2018,North-West,Wholesale and retail trade,Total ,5752,5113,6243,1130
2018,North-West,Transportation and storage,Total ,5549,5538,5556,18
2018,North-West,Hotels and restaurants,Total ,4285,4301,4271,-30
2018,North-West,Information and communication,Total ,8323,6890,8829,1939
2018,North-West,Financial and insurance services,Total ,9039,7360,10394,3034
2018,North-West,Professional services,Total ,7945,7024,8595,1571
2018,North-West,Other business services,Total ,5664,4991,5845,854
2018,North-West,Health and social work,Total ,6377,6154,7100,946
2018,North-West,Arts and recreation,Total ,6263,5918,6528,610
2018,North-West,Other service activities,Total ,5929,5042,7343,2301
2018,North-West,TOTAL,T/U/M Management,10643,9412,10968,1556
2018,North-West,SECTOR 2 PRODUCTION,T/U/M Management,11429,15392,10938,-4454
,,,,0,0,0,0
2018,North-West,Manufacturing of Goods,T/U/M Management,14074,15998,13457,-2541
,,,,10111,0,10111,10111
,,,,8854,0,8857,8857
2018,North-West,SECTOR 3 SERVICES ,T/U/M Management,10114,8512,10998,2486
2018,North-West,Wholesale and retail trade,T/U/M Management,9855,9131,10341,1210
,,,,8873,0,9140,9140
2018,North-West,Hotels and restaurants,T/U/M Management,5579,5271,5778,507
2018,North-West,Information and communication,T/U/M Management,11211,8375,11536,3161
2018,North-West,Financial and insurance services,T/U/M Management,15500,13148,16083,2935
2018,North-West,Professional services,T/U/M Management,11008,9545,11220,1675
2018,North-West,Other business services,T/U/M Management,8254,7471,8718,1247
2018,North-West,Health and social work,T/U/M Management,9109,8104,11111,3007
2018,North-West,Arts and recreation,T/U/M Management,7853,7279,8000,721
2018,North-West,Other service activities,T/U/M Management,8807,7527,9367,1840
2018,North-West,TOTAL,Lower management,8453,7612,8932,1320
2018,North-West,SECTOR 2 PRODUCTION,Lower management,8795,9239,8688,-551
,,,,0,0,0,0
2018,North-West,Manufacturing of Goods,Lower management,9616,9935,9549,-386
,,,,0,0,0,0
,,,,7437,0,7429,7429
2018,North-West,SECTOR 3 SERVICES ,Lower management,8250,7232,9068,1836
2018,North-West,Wholesale and retail trade,Lower management,7405,6316,8116,1800
,,,,7601,0,7901,7901
2018,North-West,Hotels and restaurants,Lower management,5001,4875,5200,325
2018,North-West,Information and communication,Lower management,8047,7720,8673,953
2018,North-West,Financial and insurance services,Lower management,11670,10444,12019,1575
2018,North-West,Professional services,Lower management,9374,8450,9856,1406
2018,North-West,Other business services,Lower management,6500,5712,6715,1003
2018,North-West,Health and social work,Lower management,7383,7064,8109,1045
2018,North-West,Arts and recreation,Lower management,6585,6397,6965,568
2018,North-West,Other service activities,Lower management,6992,6130,7989,1859
2018,North-West,TOTAL,Lowest management,7480,7051,7793,742
2018,North-West,SECTOR 2 PRODUCTION,Lowest management,7062,6790,7148,358
,,,,0,0,0,0
2018,North-West,Manufacturing of Goods,Lowest management,7082,6771,7237,466
,,,,7644,0,7880,7880
,,,,6729,0,6729,6729
2018,North-West,SECTOR 3 SERVICES ,Lowest management,7683,7095,8309,1214
2018,North-West,Wholesale and retail trade,Lowest management,6687,5546,7263,1717
2018,North-West,Transportation and storage,Lowest management,7353,7353,7304,-49
2018,North-West,Hotels and restaurants,Lowest management,4764,4707,4887,180
,,,,9588,0,10080,10080
2018,North-West,Financial and insurance services,Lowest management,9441,8528,9909,1381
2018,North-West,Professional services,Lowest management,8858,8361,9183,822
2018,North-West,Other business services,Lowest management,7373,6528,7910,1382
2018,North-West,Health and social work,Lowest management,6652,6540,7270,730
2018,North-West,Arts and recreation,Lowest management,6544,6190,7196,1006
2018,North-West,Other service activities,Lowest management,6291,5278,7670,2392
2018,North-West,TOTAL,No management,6118,5880,6240,360
2018,North-West,SECTOR 2 PRODUCTION,No management,6327,5959,6394,435
,,,,6248,0,6248,6248
2018,North-West,Manufacturing of Goods,No management,6483,5995,6598,603
2018,North-West,Waste disposal,No management,5754,5669,5778,109
2018,North-West,Construction ,No management,6002,5631,6050,419
2018,North-West,SECTOR 3 SERVICES ,No management,5976,5865,6092,227
2018,North-West,Wholesale and retail trade,No management,5259,4891,5609,718
2018,North-West,Transportation and storage,No management,5297,5370,5282,-88
2018,North-West,Hotels and restaurants,No management,4077,4162,3921,-241
2018,North-West,Information and communication,No management,7739,6645,8086,1441
2018,North-West,Financial and insurance services,No management,7193,6807,7806,999
2018,North-West,Professional services,No management,6949,6568,7268,700
2018,North-West,Other business services,No management,5388,4628,5588,960
2018,North-West,Health and social work,No management,6108,5979,6588,609
2018,North-West,Arts and recreation,No management,5952,5623,6238,615
2018,North-West,Other service activities,No management,5063,4503,6048,1545
2016,North-West,TOTAL,Total ,6700,6220,7034,814
,,,,6931,6768,6960,192
,,,,6890,0,6890,6890
,,,,7430,7022,7560,538
2016,North-West,Waste disposal,Total ,6466,6031,6575,544
2016,North-West,Construction ,Total ,6011,5900,6022,122
2016,North-West,SECTOR 3 SERVICES ,Total ,6585,6143,7087,944
2016,North-West,Wholesale and retail trade,Total ,5811,5025,6499,1474
2016,North-West,Transportation and storage,Total ,5848,5754,5877,123
2016,North-West,Hotels and restaurants,Total ,4513,4452,4569,117
2016,North-West,Information and communication,Total ,8341,6908,8867,1959
2016,North-West,Financial and insurance services,Total ,8579,7108,10113,3005
2016,North-West,Professional services,Total ,7916,7098,8616,1518
2016,North-West,Other business services,Total ,5673,5088,5832,744
2016,North-West,Health and social work,Total ,6402,6208,7133,925
2016,North-West,Arts and recreation,Total ,6125,5673,6533,860
2016,North-West,Other service activities,Total ,5957,5130,7170,2040
2016,North-West,TOTAL,T/U/M Management,10745,9384,11172,1788
,,,,12149,13906,11868,-2038
,,,,0,0,0,0
,,,,13549,15192,13080,-2112
,,,,9969,0,9969,9969
,,,,8491,0,8665,8665
2016,North-West,SECTOR 3 SERVICES ,T/U/M Management,10064,8665,10790,2125
,,,,9387,8142,9716,1574
,,,,9518,7111,9555,2444
,,,,6190,5982,6400,418
,,,,11093,9005,11486,2481
2016,North-West,Financial and insurance services,T/U/M Management,15496,11979,16121,4142
,,,,10995,9322,11345,2023
,,,,8217,6789,8377,1588
2016,North-West,Health and social work,T/U/M Management,9800,8479,11786,3307
,,,,8268,7529,8667,1138
,,,,9092,8498,9412,914
2016,North-West,TOTAL,Lower management,8723,7656,9148,1492
,,,,9229,9544,9167,-377
,,,,0,0,0,0
,,,,9828,9880,9812,-68
,,,,8639,0,0,0
,,,,6808,0,6852,6852
2016,North-West,SECTOR 3 SERVICES ,Lower management,8385,7331,9137,1806
2016,North-West,Wholesale and retail trade,Lower management,7622,6973,7990,1017
2016,North-West,Transportation and storage,Lower management,8468,8169,8489,320
2016,North-West,Hotels and restaurants,Lower management,4951,4840,5155,315
2016,North-West,Information and communication,Lower management,9385,7774,10080,2306
2016,North-West,Financial and insurance services,Lower management,11156,9656,11674,2018
,,,,9448,7780,9966,2186
,,,,7175,6648,7907,1259
2016,North-West,Health and social work,Lower management,7355,6975,8277,1302
,,,,7213,6681,7530,849
,,,,7032,6307,8262,1955
2016,North-West,TOTAL,Lowest management,7484,7084,7716,632
,,,,7092,7091,7094,3
,,,,0,0,0,0
,,,,7376,7094,7480,386
,,,,7464,0,7541,7541
,,,,6636,0,6652,6652
2016,North-West,SECTOR 3 SERVICES ,Lowest management,7684,7077,8222,1145
,,,,6967,6088,7685,1597
2016,North-West,Transportation and storage,Lowest management,7098,6699,7393,694
,,,,4782,4782,0,-4782
,,,,8687,0,9098,9098
2016,North-West,Financial and insurance services,Lowest management,9178,8246,9712,1466
,,,,9386,8384,9746,1362
,,,,6190,5637,6292,655
2016,North-West,Health and social work,Lowest management,6964,6873,7153,280
,,,,6699,6754,0,-6754
,,,,5708,4843,0,-4843
2016,North-West,TOTAL,No management,6129,5862,6286,424
2016,North-West,SECTOR 2 PRODUCTION,No management,6317,6159,6346,187
,,,,6632,0,6636,6636
,,,,6582,6217,6689,472
2016,North-West,Waste disposal,No management,6034,5891,6101,210
2016,North-West,Construction ,No management,5839,5737,5843,106
2016,North-West,SECTOR 3 SERVICES ,No management,6020,5800,6225,425
2016,North-West,Wholesale and retail trade,No management,5223,4780,5708,928
2016,North-West,Transportation and storage,No management,5519,5495,5526,31
2016,North-West,Hotels and restaurants,No management,4332,4337,4258,-79
2016,North-West,Information and communication,No management,7664,6583,8095,1512
2016,North-West,Financial and insurance services,No management,6982,6581,7654,1073
2016,North-West,Professional services,No management,6977,6602,7327,725
2016,North-West,Other business services,No management,5545,4893,5693,800
2016,North-West,Health and social work,No management,6128,6024,6539,515
2016,North-West,Arts and recreation,No management,5588,5295,6055,760
2016,North-West,Other service activities,No management,5010,4534,5950,1416
2014,North-West,TOTAL,Total ,6578,6014,6934,920
2014,North-West,SECTOR 2 PRODUCTION,Total ,6827,6800,6836,36
,,,,6115,0,6070,6070
,,,,7291,6887,7390,503
,,,,6364,6223,6400,177
,,,,6068,6066,6072,6
2014,North-West,SECTOR 3 SERVICES ,Total ,6435,5881,7033,1152
2014,North-West,Wholesale and retail trade,Total ,5722,4924,6397,1473
2014,North-West,Transportation and storage,Total ,6210,5732,6341,609
2014,North-West,Hotels and restaurants,Total ,4333,4323,4385,62
2014,North-West,Information and communication,Total ,8165,6537,8619,2082
2014,North-West,Financial and insurance services,Total ,8461,6974,9886,2912
2014,North-West,Professional services,Total ,7975,6867,8583,1716
2014,North-West,Other business services,Total ,5462,4691,5618,927
2014,North-West,Health and social work,Total ,6259,6062,7001,939
2014,North-West,Arts and recreation,Total ,6315,5858,6561,703
,,,,6083,5092,7248,2156
2014,North-West,TOTAL,T/U/M Management,10455,8670,11061,2391
,,,,12262,13874,12029,-1845
,,,,0,0,0,0
,,,,14143,15793,13689,-2104
,,,,10642,0,10666,10666
,,,,8099,0,8611,8611
2014,North-West,SECTOR 3 SERVICES ,T/U/M Management,9918,8117,10627,2510
,,,,8447,7035,8889,1854
,,,,10371,7583,10581,2998
,,,,5920,5344,6429,1085
,,,,11141,0,11498,11498
2014,North-West,Financial and insurance services,T/U/M Management,14524,11977,14906,2929
,,,,11403,9540,11865,2325
,,,,9192,7680,9687,2007
2014,North-West,Health and social work,T/U/M Management,9322,8641,10854,2213
,,,,7670,6857,7888,1031
,,,,8378,7281,9389,2108
2014,North-West,TOTAL,Lower management,8667,7425,9087,1662
,,,,9166,9210,9160,-50
,,,,0,0,0,0
,,,,9669,9756,9654,-102
,,,,8376,0,8435,8435
,,,,7070,0,7209,7209
2014,North-West,SECTOR 3 SERVICES ,Lower management,8162,7167,8981,1814
,,,,7388,6551,7586,1035
,,,,8500,0,8343,8343
,,,,4643,0,0,0
,,,,9124,0,9464,9464
2014,North-West,Financial and insurance services,Lower management,10855,9479,11291,1812
,,,,9234,7507,10007,2500
,,,,6725,6928,6551,-377
2014,North-West,Health and social work,Lower management,7295,7123,7905,782
,,,,7659,0,7715,7715
,,,,7223,6764,8228,1464
2014,North-West,TOTAL,Lowest management,7269,6810,7574,764
,,,,7055,7502,7032,-470
,,,,0,0,0,0
2014,North-West,Manufacturing of Goods,Lowest management,7438,7724,7389,-335
,,,,7922,0,8137,8137
,,,,6442,0,6475,6475
2014,North-West,SECTOR 3 SERVICES ,Lowest management,7400,6749,8078,1329
,,,,6531,5430,7559,2129
,,,,7223,6500,7825,1325
,,,,4719,0,0,0
,,,,7168,0,7811,7811
2014,North-West,Financial and insurance services,Lowest management,9345,8430,9733,1303
,,,,8555,7648,8882,1234
,,,,6047,0,6065,6065
2014,North-West,Health and social work,Lowest management,6612,6494,6933,439
,,,,6399,0,0,0
,,,,6813,6542,6898,356
2014,North-West,TOTAL,No management,5975,5613,6175,562
2014,North-West,SECTOR 2 PRODUCTION,No management,6215,6114,6240,126
,,,,5639,0,5666,5666
2014,North-West,Manufacturing of Goods,No management,6471,6148,6542,394
,,,,5843,5820,5843,23
2014,North-West,Construction ,No management,5796,5758,5796,38
2014,North-West,SECTOR 3 SERVICES ,No management,5796,5511,6103,592
2014,North-West,Wholesale and retail trade,No management,5092,4704,5546,842
,,,,5933,5479,6048,569
2014,North-West,Hotels and restaurants,No management,4228,4182,4238,56
2014,North-West,Information and communication,No management,7161,6312,7524,1212
2014,North-West,Financial and insurance services,No management,6777,6426,7417,991
2014,North-West,Professional services,No management,6908,6486,7312,826
2014,North-West,Other business services,No management,5149,4378,5393,1015
2014,North-West,Health and social work,No management,5893,5815,6292,477
2014,North-West,Arts and recreation,No management,5940,5487,6329,842
2014,North-West,Other service activities,No management,4976,4460,6124,1664
2012,North-West,TOTAL,Total ,6653,5981,7094,1113
2012,North-West,SECTOR 2 PRODUCTION,Total ,6930,6576,7023,447
,,,,6231,0,6233,6233
,,,,7396,6822,7577,755
,,,,6086,5417,6190,773
,,,,6105,5420,6153,733
2012,North-West,SECTOR 3 SERVICES ,Total ,6502,5863,7154,1291
2012,North-West,Wholesale and retail trade,Total ,5553,4748,6192,1444
,,,,5885,5680,5971,291
2012,North-West,Hotels and restaurants,Total ,4365,4305,4502,197
2012,North-West,Information and communication,Total ,8156,6426,8770,2344
2012,North-West,Financial and insurance services,Total ,8411,6806,9988,3182
2012,North-West,Professional services,Total ,7897,6659,8828,2169
2012,North-West,Other business services,Total ,5038,4281,5397,1116
2012,North-West,Health and social work,Total ,6187,5991,6950,959
2012,North-West,Arts and recreation,Total ,5922,5445,6400,955
,,,,6067,5013,8476,3463
2012,North-West,TOTAL,T/U/M Management,10670,8789,11239,2450
,,,,11940,13502,11770,-1732
,,,,0,0,0,0
,,,,14000,15253,13660,-1593
,,,,9678,0,9964,9964
,,,,8091,6248,8450,2202
2012,North-West,SECTOR 3 SERVICES ,T/U/M Management,10217,8328,11045,2717
,,,,9071,7379,9848,2469
,,,,9968,7554,10389,2835
,,,,5538,5119,5754,635
2012,North-West,Information and communication,T/U/M Management,11111,7828,11550,3722
2012,North-West,Financial and insurance services,T/U/M Management,14940,12262,15410,3148
,,,,12381,9750,12944,3194
,,,,7649,6643,7732,1089
2012,North-West,Health and social work,T/U/M Management,9126,8219,10942,2723
,,,,7919,6969,8405,1436
,,,,9983,8125,10099,1974
2012,North-West,TOTAL,Lower management,8543,7071,9104,2033
,,,,9178,8670,9265,595
,,,,0,0,0,0
,,,,9572,9143,9625,482
,,,,8461,0,8547,8547
,,,,7205,0,7378,7378
2012,North-West,SECTOR 3 SERVICES ,Lower management,8070,6781,8982,2201
2012,North-West,Wholesale and retail trade,Lower management,7186,6283,8052,1769
,,,,7057,7216,7057,-159
,,,,5007,5075,4945,-130
2012,North-West,Information and communication,Lower management,9741,7583,10208,2625
2012,North-West,Financial and insurance services,Lower management,10732,9406,11110,1704
2012,North-West,Professional services,Lower management,9537,7733,10387,2654
,,,,5759,6095,5702,-393
2012,North-West,Health and social work,Lower management,7101,6773,7750,977
,,,,6829,6476,7118,642
,,,,6286,5878,8649,2771
2012,North-West,TOTAL,Lowest management,7289,6837,7533,696
,,,,7063,7057,7062,5
,,,,0,0,0,0
,,,,7408,7435,7405,-30
,,,,7212,0,7407,7407
,,,,6520,0,6532,6532
2012,North-West,SECTOR 3 SERVICES ,Lowest management,7428,6819,8025,1206
,,,,6274,5621,6533,912
,,,,7508,6909,7615,706
2012,North-West,Hotels and restaurants,Lowest management,4844,4611,5055,444
,,,,8131,0,8143,8143
2012,North-West,Financial and insurance services,Lowest management,8826,8026,9341,1315
,,,,8851,7250,9817,2567
,,,,4183,3947,4545,598
2012,North-West,Health and social work,Lowest management,6806,6635,7208,573
,,,,6221,5520,6922,1402
,,,,5464,5464,0,-5464
2012,North-West,TOTAL,No management,6024,5610,6277,667
2012,North-West,SECTOR 2 PRODUCTION,No management,6267,6043,6308,265
,,,,5955,0,5974,5974
,,,,6551,6175,6660,485
,,,,5494,5143,5543,400
,,,,5830,5363,5863,500
2012,North-West,SECTOR 3 SERVICES ,No management,5850,5511,6234,723
2012,North-West,Wholesale and retail trade,No management,5009,4559,5506,947
,,,,5560,5481,5582,101
2012,North-West,Hotels and restaurants,No management,4229,4202,4230,28
2012,North-West,Information and communication,No management,7182,6069,7619,1550
2012,North-West,Financial and insurance services,No management,6624,6249,7399,1150
2012,North-West,Professional services,No management,6855,6279,7222,943
2012,North-West,Other business services,No management,4732,4158,5127,969
2012,North-West,Health and social work,No management,5827,5764,6138,374
2012,North-West,Arts and recreation,No management,5567,5143,5896,753
,,,,4887,4350,6093,1743
2020,East,TOTAL,Total ,6274,5687,6559,872
2020,East,SECTOR 2 PRODUCTION,Total ,6255,5296,6437,1141
,,,,6226,0,6300,6300
2020,East,Manufacturing of Goods,Total ,6267,5158,6589,1431
2020,East,Waste disposal,Total ,6363,6442,6359,-83
2020,East,Construction ,Total ,6189,5886,6210,324
2020,East,SECTOR 3 SERVICES ,Total ,6292,5822,6749,927
2020,East,Wholesale and retail trade,Total ,5624,4979,6167,1188
2020,East,Transportation and storage,Total ,5473,4995,5575,580
2020,East,Hotels and restaurants,Total ,4444,4317,4642,325
2020,East,Information and communication,Total ,7894,6339,8423,2084
2020,East,Financial and insurance services,Total ,8359,6911,10152,3241
2020,East,Professional services,Total ,7321,6219,8111,1892
2020,East,Other business services,Total ,5061,4418,5429,1011
2020,East,Health and social work,Total ,6334,6078,7228,1150
2020,East,Arts and recreation,Total ,5503,5333,5714,381
2020,East,Other service activities,Total ,6270,5454,7447,1993
2020,East,TOTAL,T/U/M Management,9174,7452,9619,2167
2020,East,SECTOR 2 PRODUCTION,T/U/M Management,9053,6752,9284,2532
,,,,0,0,0,0
2020,East,Manufacturing of Goods,T/U/M Management,9453,6936,9705,2769
,,,,9005,0,9081,9081
2020,East,Construction ,T/U/M Management,8441,6524,8743,2219
2020,East,SECTOR 3 SERVICES ,T/U/M Management,9238,7613,9970,2357
2020,East,Wholesale and retail trade,T/U/M Management,8079,5908,8780,2872
2020,East,Transportation and storage,T/U/M Management,7498,7124,7579,455
2020,East,Hotels and restaurants,T/U/M Management,5431,5131,5777,646
2020,East,Information and communication,T/U/M Management,10424,8218,10839,2621
2020,East,Financial and insurance services,T/U/M Management,14444,12536,14785,2249
2020,East,Professional services,T/U/M Management,10424,8155,10984,2829
2020,East,Other business services,T/U/M Management,8296,6678,8597,1919
2020,East,Health and social work,T/U/M Management,9776,8531,11294,2763
2020,East,Arts and recreation,T/U/M Management,7628,6997,8028,1031
2020,East,Other service activities,T/U/M Management,8359,7097,9099,2002
2020,East,TOTAL,Lower management,7645,6851,7992,1141
2020,East,SECTOR 2 PRODUCTION,Lower management,7622,6541,7704,1163
,,,,0,0,0,0
2020,East,Manufacturing of Goods,Lower management,7963,6673,8232,1559
,,,,7922,0,0,0
,,,,7014,0,7040,7040
2020,East,SECTOR 3 SERVICES ,Lower management,7666,6902,8328,1426
2020,East,Wholesale and retail trade,Lower management,7301,6068,7805,1737
,,,,6583,0,6703,6703
2020,East,Hotels and restaurants,Lower management,5181,4971,5777,806
2020,East,Information and communication,Lower management,8855,6954,9524,2570
2020,East,Financial and insurance services,Lower management,10825,9272,11163,1891
2020,East,Professional services,Lower management,8155,6626,8660,2034
2020,East,Other business services,Lower management,6476,5883,6682,799
2020,East,Health and social work,Lower management,7301,7022,7873,851
2020,East,Arts and recreation,Lower management,6499,5860,6740,880
2020,East,Other service activities,Lower management,7552,6710,8698,1988
2020,East,TOTAL,Lowest management,6682,6099,6887,788
2020,East,SECTOR 2 PRODUCTION,Lowest management,6766,6099,6861,762
,,,,0,0,0,0
2020,East,Manufacturing of Goods,Lowest management,6818,6075,6950,875
,,,,7272,0,0,0
,,,,6665,0,6665,6665
2020,East,SECTOR 3 SERVICES ,Lowest management,6619,6097,6931,834
2020,East,Wholesale and retail trade,Lowest management,6015,5560,6588,1028
2020,East,Transportation and storage,Lowest management,5930,5199,6116,917
2020,East,Hotels and restaurants,Lowest management,4670,4327,4951,624
2020,East,Information and communication,Lowest management,7581,5727,8338,2611
2020,East,Financial and insurance services,Lowest management,8737,7984,9249,1265
2020,East,Professional services,Lowest management,7693,6672,8143,1471
2020,East,Other business services,Lowest management,5622,5068,6014,946
2020,East,Health and social work,Lowest management,6766,6619,6914,295
,,,,5281,0,0,0
2020,East,Other service activities,Lowest management,6500,6300,6808,508
2020,East,TOTAL,No management,5850,5449,6057,608
2020,East,SECTOR 2 PRODUCTION,No management,5915,5100,6086,986
,,,,5772,0,5735,5735
2020,East,Manufacturing of Goods,No management,5894,4988,6187,1199
2020,East,Waste disposal,No management,5789,6147,5776,-371
2020,East,Construction ,No management,5911,5673,5925,252
2020,East,SECTOR 3 SERVICES ,No management,5774,5567,6000,433
2020,East,Wholesale and retail trade,No management,5234,4840,5667,827
2020,East,Transportation and storage,No management,5298,4761,5397,636
2020,East,Hotels and restaurants,No management,4235,4177,4335,158
2020,East,Information and communication,No management,7168,6235,7703,1468
2020,East,Financial and insurance services,No management,6907,6598,7726,1128
2020,East,Professional services,No management,6310,5862,6712,850
2020,East,Other business services,No management,4804,4286,5142,856
2020,East,Health and social work,No management,5920,5793,6426,633
2020,East,Arts and recreation,No management,5196,5168,5298,130
2020,East,Other service activities,No management,5300,4889,6308,1419
2018,East,TOTAL,Total ,6118,5549,6397,848
2018,East,SECTOR 2 PRODUCTION,Total ,6077,5107,6278,1171
,,,,6163,0,6163,6163
2018,East,Manufacturing of Goods,Total ,6168,5010,6487,1477
2018,East,Waste disposal,Total ,6067,5653,6067,414
2018,East,Construction ,Total ,5897,5500,5926,426
2018,East,SECTOR 3 SERVICES ,Total ,6156,5703,6586,883
2018,East,Wholesale and retail trade,Total ,5416,4785,5988,1203
2018,East,Transportation and storage,Total ,5574,5274,5650,376
2018,East,Hotels and restaurants,Total ,4455,4339,4641,302
2018,East,Information and communication,Total ,7511,6287,7996,1709
2018,East,Financial and insurance services,Total ,8142,6707,9860,3153
2018,East,Professional services,Total ,7203,6166,8062,1896
2018,East,Other business services,Total ,5223,4446,5478,1032
2018,East,Health and social work,Total ,6382,6114,7254,1140
2018,East,Arts and recreation,Total ,5200,5096,5389,293
2018,East,Other service activities,Total ,6000,5176,7190,2014
2018,East,TOTAL,T/U/M Management,8852,7338,9479,2141
2018,East,SECTOR 2 PRODUCTION,T/U/M Management,8768,7288,9001,1713
,,,,0,0,0,0
2018,East,Manufacturing of Goods,T/U/M Management,9372,7355,9638,2283
,,,,8947,0,9412,9412
,,,,8125,0,8125,8125
2018,East,SECTOR 3 SERVICES ,T/U/M Management,8883,7341,9762,2421
2018,East,Wholesale and retail trade,T/U/M Management,7714,6100,8487,2387
,,,,8125,0,8125,8125
2018,East,Hotels and restaurants,T/U/M Management,5570,5326,5910,584
2018,East,Information and communication,T/U/M Management,10704,8663,11144,2481
2018,East,Financial and insurance services,T/U/M Management,13865,9090,14294,5204
2018,East,Professional services,T/U/M Management,10313,7583,10894,3311
2018,East,Other business services,T/U/M Management,7143,5417,7738,2321
2018,East,Health and social work,T/U/M Management,9618,8559,10786,2227
2018,East,Arts and recreation,T/U/M Management,7000,6825,7646,821
2018,East,Other service activities,T/U/M Management,8556,7345,9224,1879
2018,East,TOTAL,Lower management,7535,6871,7851,980
2018,East,SECTOR 2 PRODUCTION,Lower management,7340,6330,7574,1244
,,,,0,0,0,0
2018,East,Manufacturing of Goods,Lower management,7782,6906,8026,1120
,,,,0,0,0,0
,,,,6585,0,6665,6665
2018,East,SECTOR 3 SERVICES ,Lower management,7641,7025,8155,1130
2018,East,Wholesale and retail trade,Lower management,7351,5674,7907,2233
,,,,7452,0,7548,7548
2018,East,Hotels and restaurants,Lower management,4967,4782,5238,456
,,,,9286,0,9567,9567
2018,East,Financial and insurance services,Lower management,10919,9528,11300,1772
2018,East,Professional services,Lower management,7953,7000,8423,1423
2018,East,Other business services,Lower management,6261,5402,6261,859
2018,East,Health and social work,Lower management,7422,7191,7828,637
,,,,6605,6592,0,-6592
2018,East,Other service activities,Lower management,6932,6469,7999,1530
2018,East,TOTAL,Lowest management,6539,5991,6737,746
2018,East,SECTOR 2 PRODUCTION,Lowest management,6684,6342,6684,342
,,,,0,0,0,0
2018,East,Manufacturing of Goods,Lowest management,6868,5929,7035,1106
,,,,0,0,0,0
,,,,6438,0,6438,6438
2018,East,SECTOR 3 SERVICES ,Lowest management,6400,5929,6785,856
2018,East,Wholesale and retail trade,Lowest management,6096,5565,6439,874
,,,,6386,0,6652,6652
2018,East,Hotels and restaurants,Lowest management,4746,4600,4944,344
,,,,9240,0,9630,9630
2018,East,Financial and insurance services,Lowest management,8687,7801,9303,1502
2018,East,Professional services,Lowest management,6926,5967,7545,1578
,,,,6058,0,6058,6058
2018,East,Health and social work,Lowest management,6280,6155,6638,483
,,,,5454,0,0,0
2018,East,Other service activities,Lowest management,5550,5270,6362,1092
2018,East,TOTAL,No management,5704,5277,5901,624
2018,East,SECTOR 2 PRODUCTION,No management,5766,4931,5933,1002
,,,,5918,0,5874,5874
2018,East,Manufacturing of Goods,No management,5798,4886,6097,1211
,,,,5710,0,5720,5720
2018,East,Construction ,No management,5693,5158,5717,559
2018,East,SECTOR 3 SERVICES ,No management,5629,5417,5826,409
2018,East,Wholesale and retail trade,No management,5006,4642,5418,776
2018,East,Transportation and storage,No management,5315,5124,5369,245
2018,East,Hotels and restaurants,No management,4244,4192,4316,124
2018,East,Information and communication,No management,6917,5991,7380,1389
2018,East,Financial and insurance services,No management,6641,6349,7381,1032
2018,East,Professional services,No management,6214,5795,6667,872
2018,East,Other business services,No management,4984,4319,5250,931
2018,East,Health and social work,No management,5952,5801,6425,624
2018,East,Arts and recreation,No management,4730,4695,4762,67
2018,East,Other service activities,No management,4935,4635,5802,1167
2016,East,TOTAL,Total ,6092,5520,6347,827
2016,East,SECTOR 2 PRODUCTION,Total ,6057,5126,6210,1084
,,,,6028,0,5949,5949
2016,East,Manufacturing of Goods,Total ,6096,4990,6390,1400
,,,,6259,5891,6271,380
2016,East,Construction ,Total ,5950,5958,5946,-12
2016,East,SECTOR 3 SERVICES ,Total ,6118,5668,6588,920
2016,East,Wholesale and retail trade,Total ,5388,4789,6038,1249
2016,East,Transportation and storage,Total ,5584,5037,5647,610
2016,East,Hotels and restaurants,Total ,4321,4240,4463,223
2016,East,Information and communication,Total ,7549,6140,8073,1933
2016,East,Financial and insurance services,Total ,7936,6689,9718,3029
2016,East,Professional services,Total ,6923,5988,7707,1719
,,,,5432,4666,5631,965
2016,East,Health and social work,Total ,6400,6125,7307,1182
,,,,5526,5080,5909,829
2016,East,Other service activities,Total ,5674,4960,7424,2464
2016,East,TOTAL,T/U/M Management,8920,7547,9517,1970
,,,,8873,7375,9108,1733
,,,,0,0,0,0
2016,East,Manufacturing of Goods,T/U/M Management,9341,8127,9628,1501
,,,,8462,0,8568,8568
,,,,7951,6695,8106,1411
2016,East,SECTOR 3 SERVICES ,T/U/M Management,8972,7580,9829,2249
2016,East,Wholesale and retail trade,T/U/M Management,7936,6545,8845,2300
,,,,8330,0,8482,8482
,,,,5863,5501,6065,564
,,,,10705,9040,10779,1739
,,,,14055,11264,14320,3056
2016,East,Professional services,T/U/M Management,9722,7688,10176,2488
,,,,7423,6652,7484,832
2016,East,Health and social work,T/U/M Management,8913,7969,10625,2656
,,,,7543,0,8000,8000
,,,,8000,6824,8842,2018
2016,East,TOTAL,Lower management,7413,6665,7722,1057
2016,East,SECTOR 2 PRODUCTION,Lower management,7362,6655,7482,827
,,,,0,0,0,0
2016,East,Manufacturing of Goods,Lower management,7553,6511,7791,1280
,,,,0,0,0,0
,,,,7005,7005,7019,14
2016,East,SECTOR 3 SERVICES ,Lower management,7463,6683,8054,1371
,,,,6869,5497,7529,2032
,,,,7418,6765,7599,834
,,,,4796,4679,5158,479
,,,,8404,0,8768,8768
2016,East,Financial and insurance services,Lower management,10493,9123,10811,1688
,,,,7441,6320,8137,1817
,,,,6218,0,6358,6358
2016,East,Health and social work,Lower management,7173,6771,7831,1060
,,,,5673,0,0,0
,,,,7424,6265,7970,1705
2016,East,TOTAL,Lowest management,6364,5720,6672,952
2016,East,SECTOR 2 PRODUCTION,Lowest management,6469,5562,6570,1008
,,,,0,0,0,0
2016,East,Manufacturing of Goods,Lowest management,6452,5337,6626,1289
,,,,7231,0,7243,7243
2016,East,Construction ,Lowest management,6445,6445,6424,-21
2016,East,SECTOR 3 SERVICES ,Lowest management,6278,5740,6798,1058
,,,,5673,4987,6305,1318
,,,,6524,5614,6785,1171
,,,,4775,0,4971,4971
,,,,8252,0,9116,9116
2016,East,Financial and insurance services,Lowest management,8620,7936,9153,1217
,,,,6673,5725,7808,2083
,,,,5564,0,5564,5564
2016,East,Health and social work,Lowest management,5896,5756,6559,803
,,,,0,0,0,0
,,,,6000,5158,0,-5158
2016,East,TOTAL,No management,5657,5202,5848,646
2016,East,SECTOR 2 PRODUCTION,No management,5714,4893,5875,982
,,,,5814,0,5695,5695
2016,East,Manufacturing of Goods,No management,5732,4816,5994,1178
,,,,5732,5286,5736,450
2016,East,Construction ,No management,5636,5416,5653,237
2016,East,SECTOR 3 SERVICES ,No management,5587,5337,5791,454
2016,East,Wholesale and retail trade,No management,4984,4651,5475,824
2016,East,Transportation and storage,No management,5423,4915,5506,591
2016,East,Hotels and restaurants,No management,4105,4091,4147,56
2016,East,Information and communication,No management,6823,5730,7333,1603
2016,East,Financial and insurance services,No management,6430,6257,6808,551
2016,East,Professional services,No management,5999,5708,6247,539
,,,,5145,4515,5409,894
2016,East,Health and social work,No management,6002,5888,6548,660
,,,,4926,4834,5163,329
,,,,4802,4423,5677,1254
2014,East,TOTAL,Total ,6027,5385,6343,958
2014,East,SECTOR 2 PRODUCTION,Total ,5963,4890,6175,1285
,,,,6163,0,6205,6205
2014,East,Manufacturing of Goods,Total ,5957,4797,6297,1500
2014,East,Waste disposal,Total ,5934,5424,6015,591
2014,East,Construction ,Total ,5913,5471,5947,476
2014,East,SECTOR 3 SERVICES ,Total ,6099,5571,6633,1062
2014,East,Wholesale and retail trade,Total ,5356,4727,5984,1257
2014,East,Transportation and storage,Total ,5342,4941,5420,479
2014,East,Hotels and restaurants,Total ,4373,4246,4564,318
2014,East,Information and communication,Total ,7366,5889,7789,1900
2014,East,Financial and insurance services,Total ,7757,6367,9579,3212
2014,East,Professional services,Total ,6984,6069,7689,1620
2014,East,Other business services,Total ,5195,4457,5383,926
2014,East,Health and social work,Total ,6231,5958,7230,1272
2014,East,Arts and recreation,Total ,4894,4595,5200,605
2014,East,Other service activities,Total ,5836,4702,7851,3149
2014,East,TOTAL,T/U/M Management,8653,7222,9221,1999
2014,East,SECTOR 2 PRODUCTION,T/U/M Management,8546,6872,8771,1899
,,,,0,0,0,0
,,,,8929,7016,9286,2270
,,,,8727,0,8727,8727
,,,,7965,0,8125,8125
2014,East,SECTOR 3 SERVICES ,T/U/M Management,8670,7294,9466,2172
,,,,7170,5555,7715,2160
,,,,7647,0,7884,7884
,,,,5609,5123,6087,964
,,,,10266,0,10317,10317
2014,East,Financial and insurance services,T/U/M Management,14181,11770,14411,2641
,,,,9773,8157,10246,2089
,,,,7843,0,7843,7843
2014,East,Health and social work,T/U/M Management,9276,8163,10874,2711
,,,,6588,0,6900,6900
,,,,9113,6935,9284,2349
2014,East,TOTAL,Lower management,7333,6756,7683,927
2014,East,SECTOR 2 PRODUCTION,Lower management,7222,6449,7356,907
,,,,0,0,0,0
2014,East,Manufacturing of Goods,Lower management,7504,6252,7768,1516
,,,,6421,0,6421,6421
2014,East,Construction ,Lower management,6826,7506,6787,-719
2014,East,SECTOR 3 SERVICES ,Lower management,7420,6857,7979,1122
,,,,7060,5698,7712,2014
,,,,7260,0,7260,7260
2014,East,Hotels and restaurants,Lower management,5021,4853,5055,202
,,,,8017,0,8537,8537
2014,East,Financial and insurance services,Lower management,9915,8353,10397,2044
2014,East,Professional services,Lower management,7451,6876,7976,1100
,,,,6330,0,0,0
2014,East,Health and social work,Lower management,7349,7086,7849,763
,,,,0,0,0,0
,,,,7326,6975,7930,955
2014,East,TOTAL,Lowest management,6200,5713,6442,729
2014,East,SECTOR 2 PRODUCTION,Lowest management,6310,5414,6408,994
,,,,0,0,0,0
2014,East,Manufacturing of Goods,Lowest management,6310,5200,6516,1316
,,,,0,0,0,0
2014,East,Construction ,Lowest management,6255,5810,6278,468
2014,East,SECTOR 3 SERVICES ,Lowest management,6114,5758,6500,742
,,,,5643,5027,6017,990
,,,,6190,0,6339,6339
,,,,4643,0,4643,4643
,,,,7700,0,8044,8044
2014,East,Financial and insurance services,Lowest management,8489,7538,9194,1656
,,,,6553,6261,6717,456
,,,,5159,0,5195,5195
2014,East,Health and social work,Lowest management,5963,5829,6190,361
,,,,0,0,0,0
,,,,5608,4952,0,-4952
2014,East,TOTAL,No management,5537,5065,5776,711
2014,East,SECTOR 2 PRODUCTION,No management,5583,4666,5778,1112
,,,,5940,0,5960,5960
2014,East,Manufacturing of Goods,No management,5574,4632,5889,1257
,,,,5606,0,5637,5637
,,,,5559,5158,5581,423
2014,East,SECTOR 3 SERVICES ,No management,5487,5221,5761,540
2014,East,Wholesale and retail trade,No management,4974,4620,5494,874
2014,East,Transportation and storage,No management,5101,4754,5191,437
2014,East,Hotels and restaurants,No management,4040,4038,4040,2
2014,East,Information and communication,No management,6704,5889,7094,1205
2014,East,Financial and insurance services,No management,6264,5957,6929,972
2014,East,Professional services,No management,5933,5620,6174,554
2014,East,Other business services,No management,4965,4225,5198,973
2014,East,Health and social work,No management,5761,5662,6192,530
2014,East,Arts and recreation,No management,4523,4386,4758,372
,,,,4562,4173,6118,1945
2012,East,TOTAL,Total ,5933,5151,6307,1156
2012,East,SECTOR 2 PRODUCTION,Total ,5974,4888,6165,1277
,,,,6095,0,6124,6124
2012,East,Manufacturing of Goods,Total ,5965,4803,6271,1468
,,,,6074,5040,6268,1228
2012,East,Construction ,Total ,5950,5335,5992,657
2012,East,SECTOR 3 SERVICES ,Total ,5882,5236,6569,1333
2012,East,Wholesale and retail trade,Total ,5142,4439,5841,1402
2012,East,Transportation and storage,Total ,5357,5062,5417,355
2012,East,Hotels and restaurants,Total ,4143,4022,4381,359
2012,East,Information and communication,Total ,7137,5783,7736,1953
2012,East,Financial and insurance services,Total ,7764,6230,9650,3420
2012,East,Professional services,Total ,6912,5714,7833,2119
2012,East,Other business services,Total ,5480,4832,5716,884
2012,East,Health and social work,Total ,6049,5658,7175,1517
,,,,4653,4470,4723,253
,,,,6162,4715,8037,3322
2012,East,TOTAL,T/U/M Management,8730,6781,9394,2613
,,,,8969,6972,9123,2151
,,,,0,0,0,0
,,,,9255,7723,9512,1789
,,,,8793,0,9052,9052
,,,,8250,5198,8439,3241
2012,East,SECTOR 3 SERVICES ,T/U/M Management,8589,6720,9612,2892
,,,,6912,5376,8000,2624
,,,,7449,0,7656,7656
2012,East,Hotels and restaurants,T/U/M Management,5159,4665,5778,1113
,,,,10279,7858,10786,2928
,,,,14113,9450,14452,5002
,,,,9664,7833,10105,2272
,,,,7333,6400,7729,1329
2012,East,Health and social work,T/U/M Management,9059,7825,10460,2635
,,,,6882,0,7222,7222
,,,,8851,7343,9059,1716
2012,East,TOTAL,Lower management,7131,6201,7604,1403
2012,East,SECTOR 2 PRODUCTION,Lower management,7145,6263,7353,1090
,,,,0,0,0,0
2012,East,Manufacturing of Goods,Lower management,7545,6290,7756,1466
,,,,7418,0,7666,7666
,,,,6683,6229,6825,596
2012,East,SECTOR 3 SERVICES ,Lower management,7106,6158,7854,1696
2012,East,Wholesale and retail trade,Lower management,6109,4837,6989,2152
,,,,6286,0,6853,6853
2012,East,Hotels and restaurants,Lower management,5001,4970,5007,37
2012,East,Information and communication,Lower management,7872,6310,8460,2150
2012,East,Financial and insurance services,Lower management,10583,8920,10960,2040
2012,East,Professional services,Lower management,7681,6392,8309,1917
,,,,6018,0,6169,6169
2012,East,Health and social work,Lower management,6908,6478,7587,1109
,,,,5198,0,0,0
,,,,6546,4914,0,-4914
2012,East,TOTAL,Lowest management,6192,5469,6544,1075
2012,East,SECTOR 2 PRODUCTION,Lowest management,6397,5639,6485,846
,,,,0,0,0,0
2012,East,Manufacturing of Goods,Lowest management,6467,5703,6591,888
,,,,0,0,0,0
,,,,6201,4887,6208,1321
2012,East,SECTOR 3 SERVICES ,Lowest management,6065,5455,6707,1252
2012,East,Wholesale and retail trade,Lowest management,5332,4643,5995,1352
,,,,6143,0,6163,6163
2012,East,Hotels and restaurants,Lowest management,4518,4333,4732,399
2012,East,Information and communication,Lowest management,7083,5959,7365,1406
2012,East,Financial and insurance services,Lowest management,8548,7754,9139,1385
,,,,6827,6287,7349,1062
,,,,5077,4325,5822,1497
2012,East,Health and social work,Lowest management,5792,5571,6390,819
,,,,0,0,0,0
,,,,0,0,0,0
2012,East,TOTAL,No management,5469,4895,5750,855
2012,East,SECTOR 2 PRODUCTION,No management,5581,4688,5770,1082
,,,,5943,0,5943,5943
2012,East,Manufacturing of Goods,No management,5559,4619,5839,1220
2012,East,Waste disposal,No management,5542,4854,5571,717
2012,East,Construction ,No management,5596,5240,5628,388
2012,East,SECTOR 3 SERVICES ,No management,5327,4974,5709,735
2012,East,Wholesale and retail trade,No management,4804,4342,5341,999
2012,East,Transportation and storage,No management,5236,4952,5262,310
2012,East,Hotels and restaurants,No management,3919,3865,4012,147
2012,East,Information and communication,No management,6456,5537,6947,1410
2012,East,Financial and insurance services,No management,6175,5802,6810,1008
2012,East,Professional services,No management,6016,5418,6558,1140
,,,,5153,4530,5330,800
2012,East,Health and social work,No management,5554,5400,6297,897
,,,,4220,4235,4092,-143
,,,,5507,4415,7321,2906
2020,Ticino,TOTAL,Total ,5546,5176,5738,562
2020,Ticino,SECTOR 2 PRODUCTION,Total ,5216,3737,5511,1774
,,,,6131,0,6118,6118
2020,Ticino,Manufacturing of Goods,Total ,4416,3574,4831,1257
,,,,4825,0,4825,4825
2020,Ticino,Construction ,Total ,5843,5472,5863,391
2020,Ticino,SECTOR 3 SERVICES ,Total ,5695,5462,5917,455
2020,Ticino,Wholesale and retail trade,Total ,5000,4745,5216,471
2020,Ticino,Transportation and storage,Total ,4778,4285,4872,587
2020,Ticino,Hotels and restaurants,Total ,3948,3825,4028,203
2020,Ticino,Information and communication,Total ,6074,5162,6426,1264
2020,Ticino,Financial and insurance services,Total ,8390,6615,10350,3735
2020,Ticino,Professional services,Total ,5978,5158,6661,1503
2020,Ticino,Other business services,Total ,4894,3965,5222,1257
2020,Ticino,Health and social work,Total ,6097,5881,6646,765
2020,Ticino,Arts and recreation,Total ,5298,4839,5380,541
2020,Ticino,Other service activities,Total ,4807,4159,5375,1216
2020,Ticino,TOTAL,T/U/M Management,8537,6932,9081,2149
2020,Ticino,SECTOR 2 PRODUCTION,T/U/M Management,7231,5896,7446,1550
,,,,0,0,0,0
2020,Ticino,Manufacturing of Goods,T/U/M Management,8503,6640,9191,2551
,,,,0,0,0,0
,,,,6028,0,6169,6169
2020,Ticino,SECTOR 3 SERVICES ,T/U/M Management,9027,7247,9948,2701
2020,Ticino,Wholesale and retail trade,T/U/M Management,7450,5858,8228,2370
,,,,7230,0,7230,7230
,,,,4240,0,4223,4223
,,,,8995,0,9412,9412
2020,Ticino,Financial and insurance services,T/U/M Management,13750,11506,14152,2646
2020,Ticino,Professional services,T/U/M Management,9846,7849,10287,2438
2020,Ticino,Other business services,T/U/M Management,6783,5555,7221,1666
2020,Ticino,Health and social work,T/U/M Management,9091,7937,11096,3159
,,,,6190,0,6188,6188
2020,Ticino,Other service activities,T/U/M Management,6814,5372,7765,2393
2020,Ticino,TOTAL,Lower management,7056,6381,7496,1115
2020,Ticino,SECTOR 2 PRODUCTION,Lower management,7152,5907,7498,1591
,,,,0,0,0,0
2020,Ticino,Manufacturing of Goods,Lower management,6824,5899,7099,1200
,,,,0,0,0,0
,,,,6853,0,7392,7392
2020,Ticino,SECTOR 3 SERVICES ,Lower management,7042,6471,7496,1025
2020,Ticino,Wholesale and retail trade,Lower management,6519,6478,6741,263
,,,,5091,0,5739,5739
,,,,3981,0,0,0
,,,,5835,0,6664,6664
2020,Ticino,Financial and insurance services,Lower management,9566,8615,10000,1385
2020,Ticino,Professional services,Lower management,6705,6190,7101,911
,,,,5768,0,5794,5794
2020,Ticino,Health and social work,Lower management,6248,6216,6873,657
,,,,6155,0,0,0
,,,,6482,6015,0,-6015
2020,Ticino,TOTAL,Lowest management,5942,5675,6090,415
2020,Ticino,SECTOR 2 PRODUCTION,Lowest management,5861,5132,5968,836
,,,,0,0,0,0
2020,Ticino,Manufacturing of Goods,Lowest management,5190,4761,5327,566
,,,,0,0,0,0
,,,,6157,0,6141,6141
2020,Ticino,SECTOR 3 SERVICES ,Lowest management,5970,5725,6211,486
2020,Ticino,Wholesale and retail trade,Lowest management,5522,5279,5738,459
,,,,4745,0,4794,4794
,,,,4285,0,4382,4382
,,,,6349,0,6535,6535
2020,Ticino,Financial and insurance services,Lowest management,7459,6657,8046,1389
2020,Ticino,Professional services,Lowest management,5968,5423,6410,987
2020,Ticino,Other business services,Lowest management,5416,4595,5892,1297
2020,Ticino,Health and social work,Lowest management,6573,6357,7141,784
,,,,5975,0,5987,5987
2020,Ticino,Other service activities,Lowest management,4921,4114,5789,1675
2020,Ticino,TOTAL,No management,5137,4919,5273,354
2020,Ticino,SECTOR 2 PRODUCTION,No management,4726,3521,5128,1607
,,,,5890,0,5890,5890
2020,Ticino,Manufacturing of Goods,No management,4063,3444,4449,1005
,,,,4576,0,4489,4489
2020,Ticino,Construction ,No management,5639,4603,5672,1069
2020,Ticino,SECTOR 3 SERVICES ,No management,5320,5252,5368,116
2020,Ticino,Wholesale and retail trade,No management,4659,4561,4769,208
2020,Ticino,Transportation and storage,No management,4474,4049,4634,585
2020,Ticino,Hotels and restaurants,No management,3859,3766,3921,155
2020,Ticino,Information and communication,No management,5498,4863,5739,876
2020,Ticino,Financial and insurance services,No management,6017,5775,6576,801
2020,Ticino,Professional services,No management,5054,4689,5524,835
2020,Ticino,Other business services,No management,4755,3791,5070,1279
2020,Ticino,Health and social work,No management,5850,5764,6139,375
2020,Ticino,Arts and recreation,No management,4916,4573,5164,591
2020,Ticino,Other service activities,No management,4252,3862,4806,944
2018,Ticino,TOTAL,Total ,5363,4836,5617,781
2018,Ticino,SECTOR 2 PRODUCTION,Total ,5230,3693,5535,1842
,,,,0,0,0,0
2018,Ticino,Manufacturing of Goods,Total ,4494,3541,4977,1436
,,,,4715,0,4715,4715
2018,Ticino,Construction ,Total ,5956,5830,5956,126
2018,Ticino,SECTOR 3 SERVICES ,Total ,5420,5120,5696,576
2018,Ticino,Wholesale and retail trade,Total ,4957,4625,5262,637
2018,Ticino,Transportation and storage,Total ,4940,4333,5122,789
2018,Ticino,Hotels and restaurants,Total ,4024,3816,4182,366
2018,Ticino,Information and communication,Total ,6300,4883,6807,1924
2018,Ticino,Financial and insurance services,Total ,7569,6124,9136,3012
2018,Ticino,Professional services,Total ,5864,5159,6526,1367
2018,Ticino,Other business services,Total ,4812,4236,4889,653
2018,Ticino,Health and social work,Total ,5945,5687,6695,1008
2018,Ticino,Arts and recreation,Total ,4826,4570,4996,426
2018,Ticino,Other service activities,Total ,4845,4548,5091,543
2018,Ticino,TOTAL,T/U/M Management,8254,6717,8905,2188
2018,Ticino,SECTOR 2 PRODUCTION,T/U/M Management,7982,7362,8016,654
,,,,0,0,0,0
2018,Ticino,Manufacturing of Goods,T/U/M Management,8287,6693,8645,1952
,,,,0,0,0,0
,,,,7675,0,7908,7908
2018,Ticino,SECTOR 3 SERVICES ,T/U/M Management,8558,6525,9595,3070
2018,Ticino,Wholesale and retail trade,T/U/M Management,8422,6626,8941,2315
,,,,7138,0,7292,7292
2018,Ticino,Hotels and restaurants,T/U/M Management,5196,4439,5473,1034
,,,,9726,0,10397,10397
2018,Ticino,Financial and insurance services,T/U/M Management,14020,11966,14367,2401
2018,Ticino,Professional services,T/U/M Management,9143,6717,9750,3033
2018,Ticino,Other business services,T/U/M Management,6882,6424,7231,807
2018,Ticino,Health and social work,T/U/M Management,8587,6058,11139,5081
,,,,5833,0,5833,5833
2018,Ticino,Other service activities,T/U/M Management,6449,6163,7486,1323
2018,Ticino,TOTAL,Lower management,6338,5883,6389,506
2018,Ticino,SECTOR 2 PRODUCTION,Lower management,5691,5349,5691,342
,,,,0,0,0,0
2018,Ticino,Manufacturing of Goods,Lower management,6258,5635,6431,796
,,,,0,0,0,0
,,,,5611,0,5611,5611
2018,Ticino,SECTOR 3 SERVICES ,Lower management,6567,6025,7061,1036
2018,Ticino,Wholesale and retail trade,Lower management,5812,5684,6109,425
,,,,0,0,0,0
,,,,4502,0,4643,4643
,,,,7933,0,8631,8631
2018,Ticino,Financial and insurance services,Lower management,8566,7917,9088,1171
2018,Ticino,Professional services,Lower management,6329,5811,6965,1154
,,,,6519,0,0,0
2018,Ticino,Health and social work,Lower management,6590,6224,6970,746
,,,,5417,0,0,0
,,,,5625,0,0,0
2018,Ticino,TOTAL,Lowest management,5813,5443,6016,573
2018,Ticino,SECTOR 2 PRODUCTION,Lowest management,5808,4658,6045,1387
,,,,0,0,0,0
2018,Ticino,Manufacturing of Goods,Lowest management,5280,4503,5500,997
,,,,0,0,0,0
,,,,6338,0,6370,6370
2018,Ticino,SECTOR 3 SERVICES ,Lowest management,5827,5642,6000,358
2018,Ticino,Wholesale and retail trade,Lowest management,5147,5059,5231,172
,,,,5195,0,5599,5599
,,,,4235,0,4318,4318
,,,,6223,0,6277,6277
2018,Ticino,Financial and insurance services,Lowest management,7302,6667,8028,1361
2018,Ticino,Professional services,Lowest management,6000,5516,6351,835
2018,Ticino,Other business services,Lowest management,5092,5061,5137,76
2018,Ticino,Health and social work,Lowest management,7152,6778,7938,1160
2018,Ticino,Arts and recreation,Lowest management,5387,5387,5419,32
,,,,4704,4333,0,-4333
2018,Ticino,TOTAL,No management,4852,4473,5094,621
2018,Ticino,SECTOR 2 PRODUCTION,No management,4611,3476,5146,1670
,,,,0,0,0,0
2018,Ticino,Manufacturing of Goods,No management,4060,3398,4566,1168
,,,,4318,0,4262,4262
2018,Ticino,Construction ,No management,5620,4507,5672,1165
2018,Ticino,SECTOR 3 SERVICES ,No management,4950,4848,5033,185
2018,Ticino,Wholesale and retail trade,No management,4567,4346,4762,416
2018,Ticino,Transportation and storage,No management,4415,3812,4550,738
2018,Ticino,Hotels and restaurants,No management,3853,3766,3942,176
2018,Ticino,Information and communication,No management,5591,4594,6018,1424
2018,Ticino,Financial and insurance services,No management,5946,5600,6351,751
2018,Ticino,Professional services,No management,5040,4658,5415,757
2018,Ticino,Other business services,No management,4454,3695,4633,938
2018,Ticino,Health and social work,No management,5674,5608,6018,410
2018,Ticino,Arts and recreation,No management,4334,4333,4483,150
2018,Ticino,Other service activities,No management,4251,4091,4507,416
2016,Ticino,TOTAL,Total ,5563,5119,5810,691
2016,Ticino,SECTOR 2 PRODUCTION,Total ,5305,3791,5550,1759
,,,,5871,0,5871,5871
2016,Ticino,Manufacturing of Goods,Total ,4586,3612,5009,1397
,,,,5686,6336,5364,-972
,,,,5827,5467,5841,374
2016,Ticino,SECTOR 3 SERVICES ,Total ,5726,5400,6072,672
2016,Ticino,Wholesale and retail trade,Total ,5012,4588,5337,749
2016,Ticino,Transportation and storage,Total ,5035,4500,5175,675
2016,Ticino,Hotels and restaurants,Total ,4110,3931,4230,299
2016,Ticino,Information and communication,Total ,5503,4739,5813,1074
2016,Ticino,Financial and insurance services,Total ,8050,6530,9468,2938
2016,Ticino,Professional services,Total ,6174,5523,6891,1368
,,,,4281,3537,4614,1077
2016,Ticino,Health and social work,Total ,6134,5879,6889,1010
2016,Ticino,Arts and recreation,Total ,5651,5515,5750,235
,,,,4549,3829,5199,1370
2016,Ticino,TOTAL,T/U/M Management,8558,7012,9212,2200
2016,Ticino,SECTOR 2 PRODUCTION,T/U/M Management,8252,6932,8519,1587
,,,,0,0,0,0
2016,Ticino,Manufacturing of Goods,T/U/M Management,8300,7040,8487,1447
,,,,0,0,0,0
,,,,7750,0,8252,8252
2016,Ticino,SECTOR 3 SERVICES ,T/U/M Management,8664,7059,9630,2571
,,,,8141,6941,9174,2233
,,,,7396,0,7635,7635
,,,,4852,4653,5363,710
,,,,8506,0,8622,8622
2016,Ticino,Financial and insurance services,T/U/M Management,15567,12040,16353,4313
,,,,10171,7150,11007,3857
,,,,6448,0,6271,6271
,,,,8879,7081,11303,4222
,,,,7432,0,8595,8595
,,,,5918,0,6476,6476
2016,Ticino,TOTAL,Lower management,6793,6710,6810,100
2016,Ticino,SECTOR 2 PRODUCTION,Lower management,6031,6022,6031,9
,,,,0,0,0,0
2016,Ticino,Manufacturing of Goods,Lower management,6255,5543,6447,904
,,,,0,0,0,0
,,,,5920,0,5820,5820
2016,Ticino,SECTOR 3 SERVICES ,Lower management,6949,6783,7256,473
,,,,6262,6426,6253,-173
,,,,4567,0,4835,4835
,,,,4853,0,0,0
,,,,6689,0,6793,6793
2016,Ticino,Financial and insurance services,Lower management,9738,8649,9986,1337
,,,,6497,5869,6820,951
,,,,0,0,0,0
,,,,7103,7051,7242,191
,,,,6840,0,0,0
,,,,5616,5091,0,-5091
2016,Ticino,TOTAL,Lowest management,5921,5493,6090,597
2016,Ticino,SECTOR 2 PRODUCTION,Lowest management,5878,4820,6013,1193
,,,,0,0,0,0
2016,Ticino,Manufacturing of Goods,Lowest management,5202,4611,5349,738
,,,,0,0,0,0
,,,,6256,0,6256,6256
2016,Ticino,SECTOR 3 SERVICES ,Lowest management,5952,5693,6138,445
2016,Ticino,Wholesale and retail trade,Lowest management,5007,4741,5390,649
,,,,5620,0,0,0
,,,,4698,0,5003,5003
,,,,6011,0,6297,6297
2016,Ticino,Financial and insurance services,Lowest management,7499,7062,7919,857
,,,,6362,5509,6939,1430
,,,,5198,0,0,0
2016,Ticino,Health and social work,Lowest management,7148,6761,7768,1007
2016,Ticino,Arts and recreation,Lowest management,5928,5922,6015,93
,,,,3948,0,0,0
2016,Ticino,TOTAL,No management,5067,4737,5253,516
2016,Ticino,SECTOR 2 PRODUCTION,No management,4881,3592,5218,1626
,,,,5759,0,5776,5776
2016,Ticino,Manufacturing of Goods,No management,4179,3466,4613,1147
,,,,5439,0,5338,5338
,,,,5538,5177,5573,396
2016,Ticino,SECTOR 3 SERVICES ,No management,5176,5049,5283,234
2016,Ticino,Wholesale and retail trade,No management,4459,4324,4632,308
,,,,4736,4353,4871,518
2016,Ticino,Hotels and restaurants,No management,3902,3761,3940,179
,,,,4721,4139,4833,694
2016,Ticino,Financial and insurance services,No management,6184,6030,6548,518
,,,,5307,4874,5528,654
,,,,4031,3403,4535,1132
2016,Ticino,Health and social work,No management,5768,5657,6186,529
2016,Ticino,Arts and recreation,No management,5222,4941,5328,387
2016,Ticino,Other service activities,No management,4095,3600,4960,1360
2014,Ticino,TOTAL,Total ,5485,5101,5705,604
2014,Ticino,SECTOR 2 PRODUCTION,Total ,5258,3746,5477,1731
,,,,5856,0,5856,5856
2014,Ticino,Manufacturing of Goods,Total ,4504,3584,5041,1457
,,,,5328,0,5296,5296
,,,,5521,5095,5547,452
2014,Ticino,SECTOR 3 SERVICES ,Total ,5643,5385,5956,571
2014,Ticino,Wholesale and retail trade,Total ,4860,4405,5238,833
,,,,4775,4111,5040,929
2014,Ticino,Hotels and restaurants,Total ,3895,3834,3895,61
2014,Ticino,Information and communication,Total ,5510,4841,5862,1021
2014,Ticino,Financial and insurance services,Total ,7819,6470,9273,2803
2014,Ticino,Professional services,Total ,5624,4994,6345,1351
2014,Ticino,Other business services,Total ,4435,3518,4716,1198
2014,Ticino,Health and social work,Total ,6102,5873,6872,999
2014,Ticino,Arts and recreation,Total ,5259,4906,5503,597
2014,Ticino,Other service activities,Total ,4500,4130,4762,632
2014,Ticino,TOTAL,T/U/M Management,8666,7166,9102,1936
2014,Ticino,SECTOR 2 PRODUCTION,T/U/M Management,7746,7222,7933,711
,,,,0,0,0,0
2014,Ticino,Manufacturing of Goods,T/U/M Management,7619,6707,7842,1135
,,,,0,0,0,0
,,,,7611,0,7611,7611
2014,Ticino,SECTOR 3 SERVICES ,T/U/M Management,9089,7066,10007,2941
,,,,7584,6649,8157,1508
,,,,6750,0,6663,6663
,,,,5619,0,5534,5534
,,,,8178,0,8353,8353
,,,,14921,11666,15570,3904
,,,,9828,7672,10317,2645
,,,,6934,0,7571,7571
,,,,9631,8449,11349,2900
,,,,7155,0,0,0
,,,,6116,5557,6702,1145
2014,Ticino,TOTAL,Lower management,6400,5912,6977,1065
,,,,6333,5469,6540,1071
,,,,0,0,0,0
,,,,6089,5645,6177,532
,,,,0,0,0,0
,,,,6045,0,6087,6087
2014,Ticino,SECTOR 3 SERVICES ,Lower management,6431,5981,7250,1269
,,,,5357,5011,5506,495
,,,,0,0,0,0
,,,,4476,0,0,0
,,,,6270,0,6270,6270
2014,Ticino,Financial and insurance services,Lower management,9406,8228,9683,1455
,,,,6201,6062,6729,667
,,,,5007,0,0,0
2014,Ticino,Health and social work,Lower management,6587,6261,7731,1470
,,,,6292,0,0,0
,,,,5710,5266,0,-5266
2014,Ticino,TOTAL,Lowest management,5707,5302,5850,548
2014,Ticino,SECTOR 2 PRODUCTION,Lowest management,5807,4952,5893,941
,,,,0,0,0,0
2014,Ticino,Manufacturing of Goods,Lowest management,5389,4692,5550,858
,,,,0,0,0,0
,,,,5932,0,5940,5940
2014,Ticino,SECTOR 3 SERVICES ,Lowest management,5578,5389,5792,403
,,,,5064,4509,5447,938
,,,,4307,0,4152,4152
,,,,3801,0,3801,3801
,,,,6065,0,6434,6434
2014,Ticino,Financial and insurance services,Lowest management,7298,6860,7540,680
2014,Ticino,Professional services,Lowest management,5707,5045,6645,1600
,,,,5030,0,4860,4860
,,,,7154,6851,7809,958
,,,,5886,0,5978,5978
,,,,4730,4254,0,-4254
2014,Ticino,TOTAL,No management,5136,4814,5304,490
2014,Ticino,SECTOR 2 PRODUCTION,No management,4831,3519,5196,1677
,,,,5830,0,5834,5834
2014,Ticino,Manufacturing of Goods,No management,3987,3454,4531,1077
,,,,4626,0,4611,4611
,,,,5380,4594,5394,800
2014,Ticino,SECTOR 3 SERVICES ,No management,5320,5174,5427,253
2014,Ticino,Wholesale and retail trade,No management,4364,4150,4783,633
,,,,4518,3886,4808,922
2014,Ticino,Hotels and restaurants,No management,3786,3759,3817,58
2014,Ticino,Information and communication,No management,4875,4287,5040,753
2014,Ticino,Financial and insurance services,No management,6151,5952,6464,512
2014,Ticino,Professional services,No management,4821,4410,5258,848
2014,Ticino,Other business services,No management,4212,3442,4537,1095
2014,Ticino,Health and social work,No management,5832,5726,6211,485
,,,,4875,4421,5045,624
2014,Ticino,Other service activities,No management,4026,3628,4331,703
2012,Ticino,TOTAL,Total ,5388,4753,5693,940
2012,Ticino,SECTOR 2 PRODUCTION,Total ,5092,3371,5459,2088
,,,,5570,0,5571,5571
2012,Ticino,Manufacturing of Goods,Total ,4333,3264,4938,1674
,,,,4713,0,4662,4662
2012,Ticino,Construction ,Total ,5704,4643,5735,1092
2012,Ticino,SECTOR 3 SERVICES ,Total ,5602,5159,6045,886
2012,Ticino,Wholesale and retail trade,Total ,4769,4379,5077,698
2012,Ticino,Transportation and storage,Total ,5200,4567,5341,774
2012,Ticino,Hotels and restaurants,Total ,3945,3714,4144,430
2012,Ticino,Information and communication,Total ,6508,5208,7016,1808
2012,Ticino,Financial and insurance services,Total ,7594,6190,9150,2960
,,,,6015,5416,6750,1334
2012,Ticino,Other business services,Total ,4612,3746,4822,1076
2012,Ticino,Health and social work,Total ,6019,5705,6783,1078
2012,Ticino,Arts and recreation,Total ,5639,5208,5870,662
,,,,4078,3537,4890,1353
2012,Ticino,TOTAL,T/U/M Management,8329,6422,9020,2598
,,,,8027,6533,8313,1780
,,,,0,0,0,0
,,,,7686,6317,8011,1694
,,,,0,0,0,0
,,,,8282,0,8451,8451
2012,Ticino,SECTOR 3 SERVICES ,T/U/M Management,8445,6422,9524,3102
,,,,7724,6200,8481,2281
,,,,7358,0,7695,7695
,,,,4520,3852,4746,894
,,,,8666,0,8824,8824
2012,Ticino,Financial and insurance services,T/U/M Management,13174,10317,13743,3426
,,,,10083,7302,11250,3948
,,,,6131,4875,6389,1514
,,,,8871,7785,10758,2973
,,,,8065,0,9682,9682
,,,,5159,0,5562,5562
2012,Ticino,TOTAL,Lower management,6390,5867,6740,873
,,,,5915,5146,6142,996
,,,,0,0,0,0
2012,Ticino,Manufacturing of Goods,Lower management,6109,5500,6254,754
,,,,0,0,0,0
,,,,5729,0,5793,5793
2012,Ticino,SECTOR 3 SERVICES ,Lower management,6608,6010,7064,1054
2012,Ticino,Wholesale and retail trade,Lower management,5630,5359,5789,430
,,,,4583,0,4507,4507
,,,,4230,0,4278,4278
,,,,8159,0,8203,8203
,,,,8364,7588,8730,1142
,,,,6531,5983,6929,946
,,,,5230,0,0,0
,,,,6747,6601,7096,495
,,,,6074,0,0,0
,,,,6233,5977,0,-5977
2012,Ticino,TOTAL,Lowest management,5494,4979,5747,768
,,,,5160,3421,5612,2191
,,,,0,0,0,0
,,,,4597,3373,5250,1877
,,,,0,0,0,0
,,,,5852,0,5858,5858
2012,Ticino,SECTOR 3 SERVICES ,Lowest management,5714,5508,6000,492
2012,Ticino,Wholesale and retail trade,Lowest management,4874,4602,5040,438
,,,,5284,5096,5367,271
,,,,4286,4543,4284,-259
,,,,6628,0,6903,6903
2012,Ticino,Financial and insurance services,Lowest management,7047,6493,7258,765
,,,,6190,5960,6395,435
,,,,5098,0,5569,5569
,,,,6747,6311,7700,1389
,,,,5633,4984,5847,863
,,,,3793,3669,0,-3669
2012,Ticino,TOTAL,No management,4993,4487,5292,805
2012,Ticino,SECTOR 2 PRODUCTION,No management,4759,3227,5206,1979
,,,,5471,0,5471,5471
2012,Ticino,Manufacturing of Goods,No management,3921,3131,4483,1352
,,,,4333,0,4327,4327
2012,Ticino,Construction ,No management,5523,4495,5574,1079
2012,Ticino,SECTOR 3 SERVICES ,No management,5154,4932,5397,465
2012,Ticino,Wholesale and retail trade,No management,4392,4128,4594,466
2012,Ticino,Transportation and storage,No management,5004,4290,5110,820
2012,Ticino,Hotels and restaurants,No management,3788,3616,3921,305
,,,,6284,5098,6588,1490
2012,Ticino,Financial and insurance services,No management,5872,5697,6167,470
,,,,4875,4811,4910,99
,,,,4279,3381,4659,1278
2012,Ticino,Health and social work,No management,5687,5564,6164,600
,,,,5533,5095,5619,524
2012,Ticino,Other service activities,No management,3600,3305,4700,1395
2020,Central ,TOTAL,Total ,6585,6117,6880,763
2020,Central ,SECTOR 2 PRODUCTION,Total ,6443,5712,6553,841
,,,,6716,0,6716,6716
2020,Central ,Manufacturing of Goods,Total ,6463,5563,6691,1128
2020,Central ,Waste disposal,Total ,6606,6637,6602,-35
2020,Central ,Construction ,Total ,6357,6249,6359,110
2020,Central ,SECTOR 3 SERVICES ,Total ,6678,6189,7281,1092
2020,Central ,Wholesale and retail trade,Total ,6395,5545,7014,1469
2020,Central ,Transportation and storage,Total ,5362,4934,5436,502
2020,Central ,Hotels and restaurants,Total ,4492,4429,4642,213
2020,Central ,Information and communication,Total ,8873,7143,9348,2205
2020,Central ,Financial and insurance services,Total ,8523,7090,10248,3158
2020,Central ,Professional services,Total ,7913,6899,8594,1695
2020,Central ,Other business services,Total ,5805,5136,6114,978
2020,Central ,Health and social work,Total ,6167,5985,7015,1030
2020,Central ,Arts and recreation,Total ,5575,5389,5897,508
2020,Central ,Other service activities,Total ,6341,5630,7427,1797
2020,Central ,TOTAL,T/U/M Management,9976,8569,10450,1881
2020,Central ,SECTOR 2 PRODUCTION,T/U/M Management,9558,8105,9798,1693
,,,,0,0,0,0
2020,Central ,Manufacturing of Goods,T/U/M Management,9903,8564,10000,1436
,,,,10439,0,10689,10689
2020,Central ,Construction ,T/U/M Management,9108,7000,9206,2206
2020,Central ,SECTOR 3 SERVICES ,T/U/M Management,10222,8681,10931,2250
2020,Central ,Wholesale and retail trade,T/U/M Management,9570,7849,10179,2330
,,,,6923,0,6728,6728
2020,Central ,Hotels and restaurants,T/U/M Management,5673,5158,6169,1011
2020,Central ,Information and communication,T/U/M Management,12049,9885,12157,2272
2020,Central ,Financial and insurance services,T/U/M Management,14426,11815,15070,3255
2020,Central ,Professional services,T/U/M Management,11565,10125,11982,1857
2020,Central ,Other business services,T/U/M Management,7952,7135,9282,2147
2020,Central ,Health and social work,T/U/M Management,10315,9383,11310,1927
2020,Central ,Arts and recreation,T/U/M Management,7450,6740,8050,1310
2020,Central ,Other service activities,T/U/M Management,8515,6800,9302,2502
2020,Central ,TOTAL,Lower management,8132,7502,8448,946
2020,Central ,SECTOR 2 PRODUCTION,Lower management,7929,7887,7940,53
,,,,0,0,0,0
2020,Central ,Manufacturing of Goods,Lower management,8273,7577,8355,778
,,,,0,0,0,0
,,,,7504,0,7453,7453
2020,Central ,SECTOR 3 SERVICES ,Lower management,8218,7472,8864,1392
2020,Central ,Wholesale and retail trade,Lower management,8164,7170,8566,1396
,,,,6435,0,6524,6524
2020,Central ,Hotels and restaurants,Lower management,5306,5159,5369,210
2020,Central ,Information and communication,Lower management,10035,8664,10165,1501
2020,Central ,Financial and insurance services,Lower management,10701,9836,11110,1274
2020,Central ,Professional services,Lower management,8729,8053,9231,1178
2020,Central ,Other business services,Lower management,6867,6069,6938,869
2020,Central ,Health and social work,Lower management,7118,6957,7764,807
2020,Central ,Arts and recreation,Lower management,6771,6806,6667,-139
2020,Central ,Other service activities,Lower management,7329,7273,7352,79
2020,Central ,TOTAL,Lowest management,6932,6430,7250,820
2020,Central ,SECTOR 2 PRODUCTION,Lowest management,7117,6582,7191,609
,,,,0,0,0,0
2020,Central ,Manufacturing of Goods,Lowest management,7416,6601,7579,978
,,,,0,0,0,0
,,,,6708,0,6708,6708
2020,Central ,SECTOR 3 SERVICES ,Lowest management,6840,6402,7426,1024
2020,Central ,Wholesale and retail trade,Lowest management,6746,6261,7033,772
,,,,5264,0,5271,5271
2020,Central ,Hotels and restaurants,Lowest management,4933,4762,5143,381
,,,,8847,0,9301,9301
2020,Central ,Financial and insurance services,Lowest management,8750,7693,9679,1986
2020,Central ,Professional services,Lowest management,7822,7136,8176,1040
2020,Central ,Other business services,Lowest management,6190,5467,6320,853
2020,Central ,Health and social work,Lowest management,6525,6413,7232,819
2020,Central ,Arts and recreation,Lowest management,5571,5499,5906,407
2020,Central ,Other service activities,Lowest management,6425,5674,7238,1564
2020,Central ,TOTAL,No management,6083,5800,6230,430
2020,Central ,SECTOR 2 PRODUCTION,No management,6008,5370,6109,739
,,,,6499,0,6508,6508
2020,Central ,Manufacturing of Goods,No management,5980,5246,6190,944
2020,Central ,Waste disposal,No management,6247,6390,6204,-186
2020,Central ,Construction ,No management,5976,5912,5983,71
2020,Central ,SECTOR 3 SERVICES ,No management,6134,5887,6404,517
2020,Central ,Wholesale and retail trade,No management,5803,5146,6244,1098
2020,Central ,Transportation and storage,No management,5263,4776,5349,573
2020,Central ,Hotels and restaurants,No management,4326,4325,4328,3
2020,Central ,Information and communication,No management,7981,6817,8494,1677
2020,Central ,Financial and insurance services,No management,7270,6752,8505,1753
2020,Central ,Professional services,No management,6577,6257,6979,722
2020,Central ,Other business services,No management,5580,4977,5850,873
2020,Central ,Health and social work,No management,5838,5749,6348,599
2020,Central ,Arts and recreation,No management,5106,4961,5238,277
2020,Central ,Other service activities,No management,5867,5351,6577,1226
2018,Central ,TOTAL,Total ,6438,5905,6781,876
2018,Central ,SECTOR 2 PRODUCTION,Total ,6329,5497,6471,974
,,,,6141,0,6244,6244
2018,Central ,Manufacturing of Goods,Total ,6341,5384,6594,1210
2018,Central ,Waste disposal,Total ,6308,6234,6308,74
2018,Central ,Construction ,Total ,6237,6018,6254,236
2018,Central ,SECTOR 3 SERVICES ,Total ,6513,5984,7173,1189
2018,Central ,Wholesale and retail trade,Total ,6284,5523,6852,1329
2018,Central ,Transportation and storage,Total ,5442,5059,5489,430
2018,Central ,Hotels and restaurants,Total ,4485,4385,4643,258
2018,Central ,Information and communication,Total ,8386,6736,9048,2312
2018,Central ,Financial and insurance services,Total ,8346,6884,10249,3365
2018,Central ,Professional services,Total ,7684,6580,8628,2048
2018,Central ,Other business services,Total ,5572,5021,5826,805
2018,Central ,Health and social work,Total ,6090,5855,7079,1224
2018,Central ,Arts and recreation,Total ,5520,5186,6000,814
2018,Central ,Other service activities,Total ,6189,5455,7274,1819
2018,Central ,TOTAL,T/U/M Management,9666,8190,10123,1933
2018,Central ,SECTOR 2 PRODUCTION,T/U/M Management,8985,7758,9080,1322
,,,,0,0,0,0
2018,Central ,Manufacturing of Goods,T/U/M Management,9733,8878,9844,966
,,,,9953,0,9976,9976
,,,,8429,0,8489,8489
2018,Central ,SECTOR 3 SERVICES ,T/U/M Management,10070,8233,10833,2600
2018,Central ,Wholesale and retail trade,T/U/M Management,9556,8233,10105,1872
,,,,7781,0,7815,7815
2018,Central ,Hotels and restaurants,T/U/M Management,5873,5326,6288,962
2018,Central ,Information and communication,T/U/M Management,11624,8600,11893,3293
2018,Central ,Financial and insurance services,T/U/M Management,13927,11230,14611,3381
2018,Central ,Professional services,T/U/M Management,11325,9193,11824,2631
2018,Central ,Other business services,T/U/M Management,8628,8033,9412,1379
2018,Central ,Health and social work,T/U/M Management,9091,8008,11210,3202
2018,Central ,Arts and recreation,T/U/M Management,7500,6940,7936,996
2018,Central ,Other service activities,T/U/M Management,8667,7442,9652,2210
2018,Central ,TOTAL,Lower management,7904,7112,8290,1178
2018,Central ,SECTOR 2 PRODUCTION,Lower management,7687,6854,7855,1001
,,,,0,0,0,0
2018,Central ,Manufacturing of Goods,Lower management,7823,7080,8046,966
,,,,0,0,0,0
,,,,7481,0,7485,7485
2018,Central ,SECTOR 3 SERVICES ,Lower management,7990,7203,8690,1487
2018,Central ,Wholesale and retail trade,Lower management,8329,7633,8824,1191
,,,,6183,0,6183,6183
2018,Central ,Hotels and restaurants,Lower management,5057,4952,5180,228
,,,,9685,0,10165,10165
2018,Central ,Financial and insurance services,Lower management,10598,9166,11020,1854
2018,Central ,Professional services,Lower management,8617,8050,8976,926
2018,Central ,Other business services,Lower management,6392,6857,6168,-689
2018,Central ,Health and social work,Lower management,7055,6745,7671,926
2018,Central ,Arts and recreation,Lower management,6368,5840,6772,932
2018,Central ,Other service activities,Lower management,6937,6341,7689,1348
2018,Central ,TOTAL,Lowest management,6823,6203,7059,856
2018,Central ,SECTOR 2 PRODUCTION,Lowest management,6851,6265,6933,668
,,,,0,0,0,0
2018,Central ,Manufacturing of Goods,Lowest management,6628,6001,6766,765
,,,,0,0,0,0
,,,,6933,0,6933,6933
2018,Central ,SECTOR 3 SERVICES ,Lowest management,6797,6197,7346,1149
2018,Central ,Wholesale and retail trade,Lowest management,6500,5951,6745,794
,,,,5952,0,5952,5952
2018,Central ,Hotels and restaurants,Lowest management,4886,4775,5018,243
,,,,9293,0,9474,9474
2018,Central ,Financial and insurance services,Lowest management,8750,8044,9198,1154
2018,Central ,Professional services,Lowest management,8157,7766,8417,651
2018,Central ,Other business services,Lowest management,5893,5800,6154,354
2018,Central ,Health and social work,Lowest management,6443,6043,6987,944
,,,,5443,0,0,0
,,,,6577,5368,0,-5368
2018,Central ,TOTAL,No management,5933,5652,6112,460
2018,Central ,SECTOR 2 PRODUCTION,No management,5916,5332,6040,708
,,,,5932,0,5932,5932
2018,Central ,Manufacturing of Goods,No management,5975,5239,6190,951
2018,Central ,Waste disposal,No management,5708,5841,5657,-184
2018,Central ,Construction ,No management,5822,5762,5830,68
2018,Central ,SECTOR 3 SERVICES ,No management,5949,5733,6200,467
2018,Central ,Wholesale and retail trade,No management,5617,5159,5949,790
2018,Central ,Transportation and storage,No management,5248,4959,5304,345
2018,Central ,Hotels and restaurants,No management,4298,4281,4332,51
2018,Central ,Information and communication,No management,7564,6609,8008,1399
2018,Central ,Financial and insurance services,No management,7110,6546,8577,2031
2018,Central ,Professional services,No management,6342,6056,6735,679
2018,Central ,Other business services,No management,5378,4678,5647,969
2018,Central ,Health and social work,No management,5809,5670,6471,801
2018,Central ,Arts and recreation,No management,5027,4824,5294,470
2018,Central ,Other service activities,No management,5567,5167,6432,1265
2016,Central ,TOTAL,Total ,6451,5890,6791,901
2016,Central ,SECTOR 2 PRODUCTION,Total ,6302,5416,6440,1024
,,,,6166,0,6190,6190
2016,Central ,Manufacturing of Goods,Total ,6369,5299,6658,1359
,,,,5910,5433,6054,621
2016,Central ,Construction ,Total ,6174,5880,6196,316
2016,Central ,SECTOR 3 SERVICES ,Total ,6599,6000,7235,1235
2016,Central ,Wholesale and retail trade,Total ,6024,5240,6617,1377
2016,Central ,Transportation and storage,Total ,5903,5602,5924,322
2016,Central ,Hotels and restaurants,Total ,4391,4237,4664,427
2016,Central ,Information and communication,Total ,8284,6698,9000,2302
2016,Central ,Financial and insurance services,Total ,7993,6648,10033,3385
2016,Central ,Professional services,Total ,7668,6708,8750,2042
2016,Central ,Other business services,Total ,5686,5182,5872,690
2016,Central ,Health and social work,Total ,6175,5962,7160,1198
2016,Central ,Arts and recreation,Total ,5776,5158,6333,1175
2016,Central ,Other service activities,Total ,5895,5382,7337,1955
2016,Central ,TOTAL,T/U/M Management,9786,8496,10210,1714
2016,Central ,SECTOR 2 PRODUCTION,T/U/M Management,9134,7912,9345,1433
,,,,0,0,0,0
2016,Central ,Manufacturing of Goods,T/U/M Management,9404,7998,9476,1478
,,,,9787,0,9889,9889
,,,,8612,0,8780,8780
2016,Central ,SECTOR 3 SERVICES ,T/U/M Management,10175,8592,11037,2445
,,,,9461,8461,9628,1167
,,,,8413,0,8576,8576
2016,Central ,Hotels and restaurants,T/U/M Management,6156,5561,6583,1022
2016,Central ,Information and communication,T/U/M Management,11468,8904,11681,2777
2016,Central ,Financial and insurance services,T/U/M Management,14072,10793,14538,3745
2016,Central ,Professional services,T/U/M Management,11128,9939,11864,1925
,,,,8407,7430,9150,1720
2016,Central ,Health and social work,T/U/M Management,9189,8611,10315,1704
,,,,8562,7628,9045,1417
2016,Central ,Other service activities,T/U/M Management,8873,7880,9302,1422
2016,Central ,TOTAL,Lower management,7808,7096,8175,1079
2016,Central ,SECTOR 2 PRODUCTION,Lower management,7560,6758,7612,854
,,,,0,0,0,0
2016,Central ,Manufacturing of Goods,Lower management,7887,7123,8002,879
,,,,0,0,0,0
,,,,7060,0,7123,7123
2016,Central ,SECTOR 3 SERVICES ,Lower management,7967,7117,8565,1448
2016,Central ,Wholesale and retail trade,Lower management,7596,7174,8068,894
,,,,7305,0,7305,7305
,,,,4950,4716,5010,294
,,,,8755,7043,9379,2336
2016,Central ,Financial and insurance services,Lower management,10211,8914,10834,1920
,,,,8499,7581,8970,1389
,,,,7372,6553,8105,1552
2016,Central ,Health and social work,Lower management,7193,6916,7775,859
,,,,6898,0,0,0
,,,,6706,5736,7877,2141
2016,Central ,TOTAL,Lowest management,6571,5987,6782,795
2016,Central ,SECTOR 2 PRODUCTION,Lowest management,6624,5553,6660,1107
,,,,0,0,0,0
2016,Central ,Manufacturing of Goods,Lowest management,6602,5299,6768,1469
,,,,0,0,0,0
,,,,6580,0,6574,6574
2016,Central ,SECTOR 3 SERVICES ,Lowest management,6498,6067,7004,937
2016,Central ,Wholesale and retail trade,Lowest management,6273,5926,6782,856
,,,,5963,0,0,0
,,,,4538,4415,0,-4415
,,,,8450,0,8637,8637
2016,Central ,Financial and insurance services,Lowest management,8273,7765,8768,1003
,,,,7448,7010,8304,1294
,,,,5472,0,5930,5930
2016,Central ,Health and social work,Lowest management,6272,6067,6623,556
,,,,0,0,0,0
,,,,5505,5054,0,-5054
2016,Central ,TOTAL,No management,5952,5602,6142,540
2016,Central ,SECTOR 2 PRODUCTION,No management,5908,5221,6016,795
,,,,5776,0,5818,5818
2016,Central ,Manufacturing of Goods,No management,5955,5164,6190,1026
,,,,5301,5005,5340,335
2016,Central ,Construction ,No management,5805,5724,5811,87
2016,Central ,SECTOR 3 SERVICES ,No management,5996,5709,6312,603
2016,Central ,Wholesale and retail trade,No management,5443,4861,5928,1067
2016,Central ,Transportation and storage,No management,5707,5304,5730,426
2016,Central ,Hotels and restaurants,No management,4160,4133,4228,95
2016,Central ,Information and communication,No management,7443,6390,7877,1487
2016,Central ,Financial and insurance services,No management,6904,6345,8313,1968
2016,Central ,Professional services,No management,6345,6037,6706,669
2016,Central ,Other business services,No management,5489,4930,5706,776
2016,Central ,Health and social work,No management,5879,5733,6574,841
2016,Central ,Arts and recreation,No management,5155,4814,5727,913
2016,Central ,Other service activities,No management,5331,5037,6210,1173
2014,Central ,TOTAL,Total ,6352,5812,6663,851
2014,Central ,SECTOR 2 PRODUCTION,Total ,6296,5514,6425,911
,,,,6295,0,6311,6311
2014,Central ,Manufacturing of Goods,Total ,6392,5366,6652,1286
,,,,6687,6118,6778,660
2014,Central ,Construction ,Total ,6118,5840,6136,296
2014,Central ,SECTOR 3 SERVICES ,Total ,6392,5878,6953,1075
2014,Central ,Wholesale and retail trade,Total ,5990,5230,6500,1270
2014,Central ,Transportation and storage,Total ,5440,5206,5465,259
2014,Central ,Hotels and restaurants,Total ,4372,4310,4591,281
2014,Central ,Information and communication,Total ,7867,6350,8396,2046
2014,Central ,Financial and insurance services,Total ,7755,6544,9524,2980
2014,Central ,Professional services,Total ,7539,6619,8254,1635
2014,Central ,Other business services,Total ,5680,5102,5821,719
2014,Central ,Health and social work,Total ,6136,5884,7222,1338
2014,Central ,Arts and recreation,Total ,5708,5316,5956,640
2014,Central ,Other service activities,Total ,6171,5134,7334,2200
2014,Central ,TOTAL,T/U/M Management,9618,8106,10000,1894
2014,Central ,SECTOR 2 PRODUCTION,T/U/M Management,9169,8085,9331,1246
,,,,0,0,0,0
,,,,10070,8302,10266,1964
,,,,9663,0,0,0
,,,,7936,0,8066,8066
2014,Central ,SECTOR 3 SERVICES ,T/U/M Management,9810,8121,10421,2300
,,,,8539,7737,9072,1335
,,,,7926,0,8550,8550
,,,,6052,5175,6222,1047
,,,,11030,8158,11251,3093
,,,,12683,10470,13492,3022
2014,Central ,Professional services,T/U/M Management,11216,9815,11522,1707
,,,,7890,7714,8050,336
2014,Central ,Health and social work,T/U/M Management,8740,8048,10060,2012
,,,,8214,0,8460,8460
,,,,8375,6057,9385,3328
2014,Central ,TOTAL,Lower management,7706,7082,7950,868
2014,Central ,SECTOR 2 PRODUCTION,Lower management,7596,7158,7658,500
,,,,0,0,0,0
2014,Central ,Manufacturing of Goods,Lower management,7826,7013,7960,947
,,,,0,0,0,0
,,,,6864,0,6864,6864
2014,Central ,SECTOR 3 SERVICES ,Lower management,7785,7054,8390,1336
,,,,7608,7165,7681,516
,,,,6894,0,7000,7000
,,,,5247,0,5313,5313
2014,Central ,Information and communication,Lower management,8977,7262,9516,2254
2014,Central ,Financial and insurance services,Lower management,10248,9069,10736,1667
2014,Central ,Professional services,Lower management,8369,7341,9071,1730
2014,Central ,Other business services,Lower management,6763,7051,6705,-346
2014,Central ,Health and social work,Lower management,7097,6850,7605,755
,,,,6870,6084,0,-6084
,,,,6204,5674,7575,1901
2014,Central ,TOTAL,Lowest management,6507,5961,6708,747
,,,,6708,6195,6735,540
,,,,0,0,0,0
2014,Central ,Manufacturing of Goods,Lowest management,6879,5902,7043,1141
,,,,0,0,0,0
,,,,6240,0,6281,6281
2014,Central ,SECTOR 3 SERVICES ,Lowest management,6322,5951,6664,713
,,,,5829,5387,6049,662
,,,,6402,0,6500,6500
,,,,4734,4383,0,-4383
,,,,8424,0,8941,8941
2014,Central ,Financial and insurance services,Lowest management,8452,7745,9044,1299
2014,Central ,Professional services,Lowest management,7048,6749,7341,592
,,,,5652,6190,5629,-561
2014,Central ,Health and social work,Lowest management,6449,6221,6861,640
,,,,0,0,0,0
,,,,6232,5550,0,-5550
2014,Central ,TOTAL,No management,5850,5498,6034,536
2014,Central ,SECTOR 2 PRODUCTION,No management,5838,5133,5952,819
,,,,6036,0,6082,6082
2014,Central ,Manufacturing of Goods,No management,5859,5059,6056,997
,,,,5951,0,5951,5951
2014,Central ,Construction ,No management,5772,5517,5792,275
2014,Central ,SECTOR 3 SERVICES ,No management,5859,5598,6127,529
2014,Central ,Wholesale and retail trade,No management,5397,4932,5948,1016
2014,Central ,Transportation and storage,No management,5293,5031,5309,278
2014,Central ,Hotels and restaurants,No management,4233,4181,4273,92
2014,Central ,Information and communication,No management,7000,6019,7298,1279
2014,Central ,Financial and insurance services,No management,6755,6217,8002,1785
2014,Central ,Professional services,No management,6346,6064,6527,463
2014,Central ,Other business services,No management,5504,4849,5655,806
2014,Central ,Health and social work,No management,5752,5621,6577,956
2014,Central ,Arts and recreation,No management,5055,4913,5154,241
2014,Central ,Other service activities,No management,5504,4816,6467,1651
2012,Central ,TOTAL,Total ,6313,5608,6722,1114
2012,Central ,SECTOR 2 PRODUCTION,Total ,6313,5438,6462,1024
,,,,6260,0,6260,6260
2012,Central ,Manufacturing of Goods,Total ,6525,5464,6762,1298
,,,,5870,4663,6672,2009
2012,Central ,Construction ,Total ,5980,5308,6014,706
2012,Central ,SECTOR 3 SERVICES ,Total ,6311,5646,7119,1473
2012,Central ,Wholesale and retail trade,Total ,5711,4800,6375,1575
,,,,5333,4863,5380,517
2012,Central ,Hotels and restaurants,Total ,4240,4100,4508,408
2012,Central ,Information and communication,Total ,8149,6660,8700,2040
2012,Central ,Financial and insurance services,Total ,7810,6511,9796,3285
2012,Central ,Professional services,Total ,7499,6491,8342,1851
,,,,4948,3443,5373,1930
2012,Central ,Health and social work,Total ,5913,5698,7139,1441
2012,Central ,Arts and recreation,Total ,5298,4848,5990,1142
,,,,5870,4666,7233,2567
2012,Central ,TOTAL,T/U/M Management,9500,7796,10000,2204
2012,Central ,SECTOR 2 PRODUCTION,T/U/M Management,9080,7800,9224,1424
,,,,0,0,0,0
2012,Central ,Manufacturing of Goods,T/U/M Management,9905,8700,9999,1299
,,,,10957,0,0,0
,,,,7902,0,8002,8002
2012,Central ,SECTOR 3 SERVICES ,T/U/M Management,9736,7795,10630,2835
2012,Central ,Wholesale and retail trade,T/U/M Management,8810,6152,9600,3448
,,,,7488,0,8095,8095
2012,Central ,Hotels and restaurants,T/U/M Management,5865,5056,6350,1294
,,,,11635,9292,11829,2537
2012,Central ,Financial and insurance services,T/U/M Management,12762,10190,13498,3308
,,,,11257,9287,12235,2948
,,,,6667,4823,6941,2118
2012,Central ,Health and social work,T/U/M Management,8673,7940,10357,2417
,,,,7383,0,7417,7417
,,,,7651,5569,8938,3369
2012,Central ,TOTAL,Lower management,7622,6638,8044,1406
2012,Central ,SECTOR 2 PRODUCTION,Lower management,7919,7291,7990,699
,,,,0,0,0,0
2012,Central ,Manufacturing of Goods,Lower management,8466,7687,8568,881
,,,,0,0,0,0
,,,,6780,0,6814,6814
2012,Central ,SECTOR 3 SERVICES ,Lower management,7428,6545,8089,1544
2012,Central ,Wholesale and retail trade,Lower management,6871,5984,7563,1579
,,,,6648,0,6533,6533
,,,,4870,4670,5067,397
,,,,8571,7419,8865,1446
,,,,10261,8962,10766,1804
2012,Central ,Professional services,Lower management,8000,6980,8334,1354
2012,Central ,Other business services,Lower management,5754,6216,5710,-506
2012,Central ,Health and social work,Lower management,6725,6461,7575,1114
,,,,6431,0,0,0
,,,,6281,6013,7237,1224
2012,Central ,TOTAL,Lowest management,6394,5690,6733,1043
2012,Central ,SECTOR 2 PRODUCTION,Lowest management,6691,6100,6803,703
,,,,0,0,0,0
2012,Central ,Manufacturing of Goods,Lowest management,6876,6104,7044,940
,,,,0,0,0,0
,,,,6250,0,6256,6256
2012,Central ,SECTOR 3 SERVICES ,Lowest management,6066,5545,6617,1072
,,,,5813,4980,6314,1334
,,,,5298,0,5373,5373
2012,Central ,Hotels and restaurants,Lowest management,4567,4430,4707,277
,,,,8430,5979,9423,3444
2012,Central ,Financial and insurance services,Lowest management,8454,7762,9240,1478
,,,,6320,6002,6686,684
,,,,4901,0,4948,4948
2012,Central ,Health and social work,Lowest management,6101,5763,7198,1435
,,,,0,0,0,0
,,,,5617,5363,0,-5363
2012,Central ,TOTAL,No management,5794,5357,6028,671
2012,Central ,SECTOR 2 PRODUCTION,No management,5811,5074,5930,856
,,,,6000,0,6016,6016
2012,Central ,Manufacturing of Goods,No management,5922,5085,6129,1044
,,,,5376,4249,6010,1761
2012,Central ,Construction ,No management,5644,5035,5674,639
2012,Central ,SECTOR 3 SERVICES ,No management,5778,5405,6190,785
2012,Central ,Wholesale and retail trade,No management,5200,4634,5683,1049
,,,,5225,4737,5264,527
2012,Central ,Hotels and restaurants,No management,4049,4010,4086,76
2012,Central ,Information and communication,No management,7395,6229,7854,1625
2012,Central ,Financial and insurance services,No management,6822,6263,8237,1974
2012,Central ,Professional services,No management,6129,5743,6500,757
,,,,4667,2612,5225,2613
2012,Central ,Health and social work,No management,5651,5497,6426,929
2012,Central ,Arts and recreation,No management,4896,4734,5330,596
2012,Central ,Other service activities,No management,5169,4375,6307,1932
2020,Zurich,TOTAL,Total ,7113,6435,7659,1224
2020,Zurich,SECTOR 2 PRODUCTION,Total ,6885,6157,7040,883
,,,,6139,0,6139,6139
2020,Zurich,Manufacturing of Goods,Total ,6990,5912,7351,1439
2020,Zurich,Waste disposal,Total ,6858,6654,6883,229
2020,Zurich,Construction ,Total ,6718,6605,6731,126
2020,Zurich,SECTOR 3 SERVICES ,Total ,7166,6469,7978,1509
2020,Zurich,Wholesale and retail trade,Total ,5590,5032,6435,1403
2020,Zurich,Transportation and storage,Total ,6603,5950,6838,888
2020,Zurich,Hotels and restaurants,Total ,4606,4469,4713,244
2020,Zurich,Information and communication,Total ,9748,8126,10301,2175
2020,Zurich,Financial and insurance services,Total ,10424,8717,11575,2858
2020,Zurich,Professional services,Total ,8288,7403,9246,1843
2020,Zurich,Other business services,Total ,5373,4549,5841,1292
2020,Zurich,Health and social work,Total ,6726,6510,7420,910
2020,Zurich,Arts and recreation,Total ,6790,6461,7095,634
2020,Zurich,Other service activities,Total ,6682,6193,7588,1395
2020,Zurich,TOTAL,T/U/M Management,11475,10000,12321,2321
2020,Zurich,SECTOR 2 PRODUCTION,T/U/M Management,10254,8103,10632,2529
,,,,0,0,0,0
2020,Zurich,Manufacturing of Goods,T/U/M Management,10711,8462,10952,2490
,,,,8671,0,8250,8250
2020,Zurich,Construction ,T/U/M Management,9514,7363,9787,2424
2020,Zurich,SECTOR 3 SERVICES ,T/U/M Management,11640,10086,12608,2522
2020,Zurich,Wholesale and retail trade,T/U/M Management,10415,8864,11001,2137
2020,Zurich,Transportation and storage,T/U/M Management,11006,9907,11314,1407
2020,Zurich,Hotels and restaurants,T/U/M Management,6730,6164,7000,836
2020,Zurich,Information and communication,T/U/M Management,11705,9328,12297,2969
2020,Zurich,Financial and insurance services,T/U/M Management,15081,13090,15877,2787
2020,Zurich,Professional services,T/U/M Management,13072,10981,13711,2730
2020,Zurich,Other business services,T/U/M Management,9387,9224,9394,170
2020,Zurich,Health and social work,T/U/M Management,10322,9337,12035,2698
2020,Zurich,Arts and recreation,T/U/M Management,9080,8093,9654,1561
2020,Zurich,Other service activities,T/U/M Management,9315,8034,10315,2281
2020,Zurich,TOTAL,Lower management,9524,8698,10036,1338
2020,Zurich,SECTOR 2 PRODUCTION,Lower management,8602,7785,8762,977
,,,,0,0,0,0
2020,Zurich,Manufacturing of Goods,Lower management,8571,7833,8762,929
,,,,9105,0,9076,9076
2020,Zurich,Construction ,Lower management,8315,7040,8402,1362
2020,Zurich,SECTOR 3 SERVICES ,Lower management,9687,8744,10338,1594
2020,Zurich,Wholesale and retail trade,Lower management,8454,7301,9091,1790
2020,Zurich,Transportation and storage,Lower management,9008,8700,9220,520
2020,Zurich,Hotels and restaurants,Lower management,5788,5737,5826,89
2020,Zurich,Information and communication,Lower management,11983,10855,12157,1302
2020,Zurich,Financial and insurance services,Lower management,10804,10176,11111,935
2020,Zurich,Professional services,Lower management,10379,9568,10815,1247
2020,Zurich,Other business services,Lower management,7582,6547,8009,1462
2020,Zurich,Health and social work,Lower management,8154,7891,8973,1082
2020,Zurich,Arts and recreation,Lower management,7939,7403,8456,1053
2020,Zurich,Other service activities,Lower management,8234,7907,8758,851
2020,Zurich,TOTAL,Lowest management,7993,7365,8421,1056
2020,Zurich,SECTOR 2 PRODUCTION,Lowest management,7909,7251,7937,686
,,,,0,0,0,0
2020,Zurich,Manufacturing of Goods,Lowest management,7791,6904,7937,1033
,,,,0,0,0,0
2020,Zurich,Construction ,Lowest management,7930,8536,7909,-627
2020,Zurich,SECTOR 3 SERVICES ,Lowest management,8026,7368,8638,1270
2020,Zurich,Wholesale and retail trade,Lowest management,6967,6365,7576,1211
2020,Zurich,Transportation and storage,Lowest management,6829,6401,6918,517
2020,Zurich,Hotels and restaurants,Lowest management,5130,4980,5278,298
2020,Zurich,Information and communication,Lowest management,10948,9610,11212,1602
2020,Zurich,Financial and insurance services,Lowest management,10197,9524,10712,1188
2020,Zurich,Professional services,Lowest management,8332,8057,8712,655
2020,Zurich,Other business services,Lowest management,6717,6631,6782,151
2020,Zurich,Health and social work,Lowest management,7340,7005,8032,1027
2020,Zurich,Arts and recreation,Lowest management,8106,7894,8397,503
2020,Zurich,Other service activities,Lowest management,7150,6403,7796,1393
2020,Zurich,TOTAL,No management,6166,5706,6499,793
2020,Zurich,SECTOR 2 PRODUCTION,No management,6395,5792,6508,716
,,,,5871,0,5807,5807
2020,Zurich,Manufacturing of Goods,No management,6394,5583,6715,1132
2020,Zurich,Waste disposal,No management,6341,6471,6292,-179
2020,Zurich,Construction ,No management,6355,6371,6353,-18
2020,Zurich,SECTOR 3 SERVICES ,No management,6083,5698,6496,798
2020,Zurich,Wholesale and retail trade,No management,5160,4873,5737,864
2020,Zurich,Transportation and storage,No management,6205,5592,6388,796
2020,Zurich,Hotels and restaurants,No management,4380,4332,4429,97
2020,Zurich,Information and communication,No management,8726,7529,9271,1742
2020,Zurich,Financial and insurance services,No management,7377,7057,7904,847
2020,Zurich,Professional services,No management,6995,6722,7292,570
2020,Zurich,Other business services,No management,5035,4370,5480,1110
2020,Zurich,Health and social work,No management,6333,6257,6602,345
2020,Zurich,Arts and recreation,No management,6290,6104,6429,325
2020,Zurich,Other service activities,No management,5883,5546,6495,949
2018,Zurich,TOTAL,Total ,6965,6293,7500,1207
2018,Zurich,SECTOR 2 PRODUCTION,Total ,6766,6064,6902,838
,,,,0,0,0,0
2018,Zurich,Manufacturing of Goods,Total ,6878,5759,7239,1480
2018,Zurich,Waste disposal,Total ,6604,6604,6597,-7
2018,Zurich,Construction ,Total ,6601,6585,6604,19
2018,Zurich,SECTOR 3 SERVICES ,Total ,7026,6321,7799,1478
2018,Zurich,Wholesale and retail trade,Total ,5563,4890,6475,1585
2018,Zurich,Transportation and storage,Total ,6418,5873,6607,734
2018,Zurich,Hotels and restaurants,Total ,4554,4414,4644,230
2018,Zurich,Information and communication,Total ,9384,7960,9890,1930
2018,Zurich,Financial and insurance services,Total ,10159,8176,11627,3451
2018,Zurich,Professional services,Total ,8529,7479,9533,2054
2018,Zurich,Other business services,Total ,5248,4610,5588,978
2018,Zurich,Health and social work,Total ,6723,6511,7364,853
2018,Zurich,Arts and recreation,Total ,6878,6404,7298,894
2018,Zurich,Other service activities,Total ,6531,6044,7262,1218
2018,Zurich,TOTAL,T/U/M Management,11133,9587,12138,2551
2018,Zurich,SECTOR 2 PRODUCTION,T/U/M Management,10584,8037,10791,2754
,,,,0,0,0,0
2018,Zurich,Manufacturing of Goods,T/U/M Management,10790,9112,11250,2138
,,,,11389,0,11192,11192
2018,Zurich,Construction ,T/U/M Management,10000,7549,10314,2765
2018,Zurich,SECTOR 3 SERVICES ,T/U/M Management,11207,9612,12381,2769
2018,Zurich,Wholesale and retail trade,T/U/M Management,9524,7043,10401,3358
2018,Zurich,Transportation and storage,T/U/M Management,10770,9958,10917,959
2018,Zurich,Hotels and restaurants,T/U/M Management,6259,6026,6366,340
2018,Zurich,Information and communication,T/U/M Management,11733,9486,12474,2988
2018,Zurich,Financial and insurance services,T/U/M Management,16921,13571,17579,4008
2018,Zurich,Professional services,T/U/M Management,13255,12039,13753,1714
2018,Zurich,Other business services,T/U/M Management,9597,8565,10296,1731
2018,Zurich,Health and social work,T/U/M Management,10500,9620,11496,1876
2018,Zurich,Arts and recreation,T/U/M Management,10275,9272,10777,1505
2018,Zurich,Other service activities,T/U/M Management,8666,7971,9473,1502
2018,Zurich,TOTAL,Lower management,9479,8521,10041,1520
2018,Zurich,SECTOR 2 PRODUCTION,Lower management,8882,8330,9010,680
,,,,0,0,0,0
2018,Zurich,Manufacturing of Goods,Lower management,9124,8333,9296,963
,,,,9097,0,9097,9097
2018,Zurich,Construction ,Lower management,8278,8306,8243,-63
2018,Zurich,SECTOR 3 SERVICES ,Lower management,9552,8537,10254,1717
2018,Zurich,Wholesale and retail trade,Lower management,7992,6750,9161,2411
2018,Zurich,Transportation and storage,Lower management,9358,9178,9462,284
2018,Zurich,Hotels and restaurants,Lower management,5557,5226,5608,382
2018,Zurich,Information and communication,Lower management,11300,10348,11473,1125
2018,Zurich,Financial and insurance services,Lower management,11111,10188,11703,1515
2018,Zurich,Professional services,Lower management,10254,9512,10652,1140
2018,Zurich,Other business services,Lower management,7584,6942,7881,939
2018,Zurich,Health and social work,Lower management,8157,7951,8671,720
2018,Zurich,Arts and recreation,Lower management,7580,7051,9033,1982
2018,Zurich,Other service activities,Lower management,8286,7697,8936,1239
2018,Zurich,TOTAL,Lowest management,7717,7062,8145,1083
2018,Zurich,SECTOR 2 PRODUCTION,Lowest management,7583,6651,7694,1043
,,,,0,0,0,0
2018,Zurich,Manufacturing of Goods,Lowest management,7317,6653,7479,826
,,,,7169,0,7174,7174
2018,Zurich,Construction ,Lowest management,7829,6480,7897,1417
2018,Zurich,SECTOR 3 SERVICES ,Lowest management,7747,7086,8292,1206
2018,Zurich,Wholesale and retail trade,Lowest management,6576,5857,7471,1614
2018,Zurich,Transportation and storage,Lowest management,7433,7356,7549,193
2018,Zurich,Hotels and restaurants,Lowest management,5156,5009,5322,313
2018,Zurich,Information and communication,Lowest management,9519,8334,9899,1565
2018,Zurich,Financial and insurance services,Lowest management,9603,8708,10194,1486
2018,Zurich,Professional services,Lowest management,8432,8095,8650,555
2018,Zurich,Other business services,Lowest management,6200,6079,6330,251
2018,Zurich,Health and social work,Lowest management,6956,6818,7164,346
2018,Zurich,Arts and recreation,Lowest management,7714,7336,8011,675
2018,Zurich,Other service activities,Lowest management,6782,6529,7043,514
2018,Zurich,TOTAL,No management,6086,5602,6402,800
2018,Zurich,SECTOR 2 PRODUCTION,No management,6324,5704,6434,730
,,,,0,0,0,0
2018,Zurich,Manufacturing of Goods,No management,6389,5517,6682,1165
2018,Zurich,Waste disposal,No management,6158,6290,6148,-142
2018,Zurich,Construction ,No management,6261,6392,6253,-139
2018,Zurich,SECTOR 3 SERVICES ,No management,5984,5589,6382,793
2018,Zurich,Wholesale and retail trade,No management,5077,4747,5778,1031
2018,Zurich,Transportation and storage,No management,6139,5574,6283,709
2018,Zurich,Hotels and restaurants,No management,4346,4311,4423,112
2018,Zurich,Information and communication,No management,8377,7286,8937,1651
2018,Zurich,Financial and insurance services,No management,7395,6973,8141,1168
2018,Zurich,Professional services,No management,7085,6761,7434,673
2018,Zurich,Other business services,No management,4970,4375,5303,928
2018,Zurich,Health and social work,No management,6286,6205,6572,367
2018,Zurich,Arts and recreation,No management,6413,5873,6775,902
2018,Zurich,Other service activities,No management,5701,5267,6265,998
2016,Zurich,TOTAL,Total ,6869,6191,7406,1215
2016,Zurich,SECTOR 2 PRODUCTION,Total ,6583,5772,6730,958
,,,,6423,0,6342,6342
2016,Zurich,Manufacturing of Goods,Total ,6542,5410,6923,1513
2016,Zurich,Waste disposal,Total ,6496,6418,6516,98
2016,Zurich,Construction ,Total ,6544,6565,6544,-21
2016,Zurich,SECTOR 3 SERVICES ,Total ,6960,6245,7754,1509
2016,Zurich,Wholesale and retail trade,Total ,5570,4860,6371,1511
2016,Zurich,Transportation and storage,Total ,6525,6004,6726,722
2016,Zurich,Hotels and restaurants,Total ,4495,4416,4583,167
2016,Zurich,Information and communication,Total ,9167,7740,9646,1906
2016,Zurich,Financial and insurance services,Total ,9983,8003,11348,3345
2016,Zurich,Professional services,Total ,8098,7208,8953,1745
2016,Zurich,Other business services,Total ,5273,4586,5751,1165
2016,Zurich,Health and social work,Total ,6757,6524,7427,903
2016,Zurich,Arts and recreation,Total ,6655,6000,7165,1165
,,,,6654,6040,7515,1475
2016,Zurich,TOTAL,T/U/M Management,11339,9863,12131,2268
2016,Zurich,SECTOR 2 PRODUCTION,T/U/M Management,9996,8229,10268,2039
,,,,0,0,0,0
,,,,10290,8461,10697,2236
,,,,11113,0,11117,11117
,,,,9234,7407,9521,2114
2016,Zurich,SECTOR 3 SERVICES ,T/U/M Management,11469,9944,12438,2494
,,,,9827,7810,10242,2432
,,,,10968,9985,11263,1278
2016,Zurich,Hotels and restaurants,T/U/M Management,6395,6162,6651,489
,,,,13409,10442,13655,3213
2016,Zurich,Financial and insurance services,T/U/M Management,17011,14528,17614,3086
2016,Zurich,Professional services,T/U/M Management,13185,11731,13738,2007
2016,Zurich,Other business services,T/U/M Management,9570,7750,10439,2689
2016,Zurich,Health and social work,T/U/M Management,9852,9227,10712,1485
,,,,9259,7473,9544,2071
,,,,9068,7933,9796,1863
2016,Zurich,TOTAL,Lower management,9310,8316,9959,1643
2016,Zurich,SECTOR 2 PRODUCTION,Lower management,8261,7076,8446,1370
,,,,0,0,0,0
2016,Zurich,Manufacturing of Goods,Lower management,8137,6767,8372,1605
,,,,7130,0,7338,7338
,,,,8189,7076,8279,1203
2016,Zurich,SECTOR 3 SERVICES ,Lower management,9478,8358,10225,1867
2016,Zurich,Wholesale and retail trade,Lower management,7979,6427,8873,2446
2016,Zurich,Transportation and storage,Lower management,9260,8712,9445,733
2016,Zurich,Hotels and restaurants,Lower management,5364,5151,5670,519
,,,,10684,9591,10958,1367
2016,Zurich,Financial and insurance services,Lower management,11050,10130,11451,1321
2016,Zurich,Professional services,Lower management,9933,9000,10419,1419
2016,Zurich,Other business services,Lower management,7242,6963,7584,621
2016,Zurich,Health and social work,Lower management,7848,7628,8626,998
,,,,7890,6000,8127,2127
,,,,8619,7977,9461,1484
2016,Zurich,TOTAL,Lowest management,7521,6703,8060,1357
2016,Zurich,SECTOR 2 PRODUCTION,Lowest management,7448,6615,7516,901
,,,,0,0,0,0
2016,Zurich,Manufacturing of Goods,Lowest management,7165,6268,7346,1078
,,,,6444,0,6626,6626
,,,,7500,7000,7520,520
2016,Zurich,SECTOR 3 SERVICES ,Lowest management,7540,6706,8257,1551
2016,Zurich,Wholesale and retail trade,Lowest management,6595,5844,7443,1599
,,,,7111,6665,7111,446
2016,Zurich,Hotels and restaurants,Lowest management,4950,4848,5150,302
,,,,11137,8954,11815,2861
2016,Zurich,Financial and insurance services,Lowest management,9720,8934,10184,1250
2016,Zurich,Professional services,Lowest management,8390,7894,8682,788
,,,,6008,5663,6204,541
2016,Zurich,Health and social work,Lowest management,6753,6563,7090,527
,,,,6427,5910,6648,738
,,,,5794,4802,7197,2395
2016,Zurich,TOTAL,No management,6065,5621,6392,771
2016,Zurich,SECTOR 2 PRODUCTION,No management,6190,5463,6330,867
,,,,6168,0,6151,6151
2016,Zurich,Manufacturing of Goods,No management,6130,5225,6489,1264
2016,Zurich,Waste disposal,No management,6218,6418,6210,-208
2016,Zurich,Construction ,No management,6178,6325,6168,-157
2016,Zurich,SECTOR 3 SERVICES ,No management,6021,5637,6426,789
2016,Zurich,Wholesale and retail trade,No management,5136,4726,5802,1076
2016,Zurich,Transportation and storage,No management,6150,5799,6317,518
2016,Zurich,Hotels and restaurants,No management,4328,4262,4351,89
2016,Zurich,Information and communication,No management,8206,7378,8575,1197
2016,Zurich,Financial and insurance services,No management,7289,6865,7935,1070
2016,Zurich,Professional services,No management,6902,6612,7182,570
2016,Zurich,Other business services,No management,4936,4332,5361,1029
2016,Zurich,Health and social work,No management,6323,6214,6705,491
2016,Zurich,Arts and recreation,No management,6275,5877,6696,819
2016,Zurich,Other service activities,No management,5738,5302,6161,859
2014,Zurich,TOTAL,Total ,6810,6124,7325,1201
2014,Zurich,SECTOR 2 PRODUCTION,Total ,6533,5721,6679,958
,,,,0,0,0,0
2014,Zurich,Manufacturing of Goods,Total ,6548,5394,6886,1492
2014,Zurich,Waste disposal,Total ,6495,6568,6461,-107
2014,Zurich,Construction ,Total ,6473,6464,6473,9
2014,Zurich,SECTOR 3 SERVICES ,Total ,6906,6175,7668,1493
2014,Zurich,Wholesale and retail trade,Total ,5478,4796,6348,1552
,,,,6118,5105,6407,1302
2014,Zurich,Hotels and restaurants,Total ,4463,4331,4642,311
2014,Zurich,Information and communication,Total ,8952,7568,9440,1872
2014,Zurich,Financial and insurance services,Total ,9929,7876,11315,3439
2014,Zurich,Professional services,Total ,7883,7192,8518,1326
2014,Zurich,Other business services,Total ,5608,5301,5810,509
2014,Zurich,Health and social work,Total ,6714,6496,7464,968
2014,Zurich,Arts and recreation,Total ,6793,6242,7245,1003
2014,Zurich,Other service activities,Total ,6179,5403,7228,1825
2014,Zurich,TOTAL,T/U/M Management,11482,9607,12468,2861
2014,Zurich,SECTOR 2 PRODUCTION,T/U/M Management,9967,8147,10179,2032
,,,,0,0,0,0
2014,Zurich,Manufacturing of Goods,T/U/M Management,10241,8153,10521,2368
,,,,10766,0,10818,10818
,,,,9093,0,9223,9223
2014,Zurich,SECTOR 3 SERVICES ,T/U/M Management,11693,9678,12857,3179
2014,Zurich,Wholesale and retail trade,T/U/M Management,9526,7739,10191,2452
,,,,10428,9693,10730,1037
2014,Zurich,Hotels and restaurants,T/U/M Management,6638,6163,6963,800
2014,Zurich,Information and communication,T/U/M Management,12063,9685,12317,2632
2014,Zurich,Financial and insurance services,T/U/M Management,16429,14397,16965,2568
,,,,13773,11471,14266,2795
2014,Zurich,Other business services,T/U/M Management,9583,8699,10196,1497
2014,Zurich,Health and social work,T/U/M Management,9966,9059,11006,1947
,,,,9524,8557,11055,2498
,,,,9203,8328,10234,1906
2014,Zurich,TOTAL,Lower management,9260,8319,9845,1526
2014,Zurich,SECTOR 2 PRODUCTION,Lower management,8460,8078,8502,424
,,,,0,0,0,0
2014,Zurich,Manufacturing of Goods,Lower management,8456,8254,8516,262
,,,,8503,0,8744,8744
,,,,8150,7426,8254,828
2014,Zurich,SECTOR 3 SERVICES ,Lower management,9366,8328,10067,1739
,,,,8328,7000,8990,1990
2014,Zurich,Transportation and storage,Lower management,9316,8477,9447,970
,,,,5108,4694,5469,775
2014,Zurich,Information and communication,Lower management,10839,9841,11029,1188
2014,Zurich,Financial and insurance services,Lower management,10610,9764,10952,1188
2014,Zurich,Professional services,Lower management,10069,8951,10544,1593
2014,Zurich,Other business services,Lower management,7326,6905,7446,541
2014,Zurich,Health and social work,Lower management,8008,7744,8544,800
,,,,7207,6057,7600,1543
2014,Zurich,Other service activities,Lower management,7327,6853,7730,877
2014,Zurich,TOTAL,Lowest management,7460,6756,7870,1114
2014,Zurich,SECTOR 2 PRODUCTION,Lowest management,7434,6877,7512,635
,,,,0,0,0,0
2014,Zurich,Manufacturing of Goods,Lowest management,7612,6862,7764,902
,,,,6954,0,6971,6971
,,,,7206,6473,7233,760
2014,Zurich,SECTOR 3 SERVICES ,Lowest management,7461,6756,7976,1220
2014,Zurich,Wholesale and retail trade,Lowest management,6884,6074,7387,1313
,,,,7322,7325,7322,-3
2014,Zurich,Hotels and restaurants,Lowest management,5031,4782,5262,480
,,,,10641,8843,11001,2158
2014,Zurich,Financial and insurance services,Lowest management,8373,7739,8956,1217
2014,Zurich,Professional services,Lowest management,8299,7650,8669,1019
2014,Zurich,Other business services,Lowest management,6376,6395,6356,-39
2014,Zurich,Health and social work,Lowest management,6781,6511,7555,1044
,,,,6264,0,0,0
,,,,7129,5830,7364,1534
2014,Zurich,TOTAL,No management,5988,5472,6301,829
2014,Zurich,SECTOR 2 PRODUCTION,No management,6176,5390,6309,919
,,,,0,0,0,0
2014,Zurich,Manufacturing of Goods,No management,6105,5173,6437,1264
2014,Zurich,Waste disposal,No management,6121,6439,6092,-347
2014,Zurich,Construction ,No management,6185,6310,6181,-129
2014,Zurich,SECTOR 3 SERVICES ,No management,5913,5482,6299,817
2014,Zurich,Wholesale and retail trade,No management,5042,4676,5769,1093
,,,,5748,4836,6098,1262
2014,Zurich,Hotels and restaurants,No management,4275,4226,4334,108
2014,Zurich,Information and communication,No management,8052,7168,8494,1326
2014,Zurich,Financial and insurance services,No management,7031,6710,7585,875
2014,Zurich,Professional services,No management,6663,6481,6760,279
2014,Zurich,Other business services,No management,5314,5033,5459,426
2014,Zurich,Health and social work,No management,6319,6217,6693,476
2014,Zurich,Arts and recreation,No management,6483,6043,6787,744
2014,Zurich,Other service activities,No management,5297,4780,5806,1026
2012,Zurich,TOTAL,Total ,6900,6192,7500,1308
2012,Zurich,SECTOR 2 PRODUCTION,Total ,6500,5595,6659,1064
,,,,5840,0,5876,5876
2012,Zurich,Manufacturing of Goods,Total ,6586,5419,6934,1515
2012,Zurich,Waste disposal,Total ,6602,6492,6625,133
2012,Zurich,Construction ,Total ,6335,6016,6358,342
2012,Zurich,SECTOR 3 SERVICES ,Total ,7026,6245,7901,1656
2012,Zurich,Wholesale and retail trade,Total ,5403,4727,6397,1670
2012,Zurich,Transportation and storage,Total ,6156,5502,6420,918
2012,Zurich,Hotels and restaurants,Total ,4412,4305,4633,328
2012,Zurich,Information and communication,Total ,8834,7262,9465,2203
2012,Zurich,Financial and insurance services,Total ,9907,7814,11218,3404
2012,Zurich,Professional services,Total ,7971,6918,8976,2058
,,,,5042,4379,5571,1192
2012,Zurich,Health and social work,Total ,6679,6450,7387,937
,,,,6500,5910,7092,1182
2012,Zurich,Other service activities,Total ,5970,5431,6500,1069
2012,Zurich,TOTAL,T/U/M Management,10709,9071,11826,2755
2012,Zurich,SECTOR 2 PRODUCTION,T/U/M Management,10312,8359,10534,2175
,,,,0,0,0,0
2012,Zurich,Manufacturing of Goods,T/U/M Management,10600,8095,10912,2817
,,,,11219,0,11493,11493
,,,,9524,8591,9624,1033
2012,Zurich,SECTOR 3 SERVICES ,T/U/M Management,10774,9091,12045,2954
2012,Zurich,Wholesale and retail trade,T/U/M Management,9711,7568,10776,3208
,,,,10821,8501,11258,2757
2012,Zurich,Hotels and restaurants,T/U/M Management,6445,6109,6667,558
2012,Zurich,Information and communication,T/U/M Management,12431,9480,12778,3298
2012,Zurich,Financial and insurance services,T/U/M Management,16613,14392,17067,2675
,,,,13843,11395,14314,2919
,,,,8934,7529,8986,1457
2012,Zurich,Health and social work,T/U/M Management,9652,8724,10652,1928
,,,,8731,7461,9405,1944
,,,,8708,7851,9196,1345
2012,Zurich,TOTAL,Lower management,8940,7936,9524,1588
2012,Zurich,SECTOR 2 PRODUCTION,Lower management,8180,7141,8335,1194
,,,,0,0,0,0
2012,Zurich,Manufacturing of Goods,Lower management,8217,7405,8385,980
,,,,8691,0,8865,8865
,,,,7957,6150,8130,1980
2012,Zurich,SECTOR 3 SERVICES ,Lower management,9066,7979,9760,1781
2012,Zurich,Wholesale and retail trade,Lower management,8028,6190,8908,2718
2012,Zurich,Transportation and storage,Lower management,9467,8921,9602,681
2012,Zurich,Hotels and restaurants,Lower management,5673,5331,5847,516
,,,,10310,8544,10579,2035
2012,Zurich,Financial and insurance services,Lower management,10714,10050,10985,935
2012,Zurich,Professional services,Lower management,9842,8763,10306,1543
2012,Zurich,Other business services,Lower management,7265,6736,7584,848
2012,Zurich,Health and social work,Lower management,7925,7700,8258,558
,,,,7141,6325,7296,971
,,,,6551,6444,6952,508
2012,Zurich,TOTAL,Lowest management,7143,6567,7470,903
2012,Zurich,SECTOR 2 PRODUCTION,Lowest management,7212,6941,7255,314
,,,,0,0,0,0
2012,Zurich,Manufacturing of Goods,Lowest management,7227,6492,7334,842
,,,,7753,0,7859,7859
,,,,7067,7725,7004,-721
2012,Zurich,SECTOR 3 SERVICES ,Lowest management,7142,6542,7576,1034
2012,Zurich,Wholesale and retail trade,Lowest management,6387,5707,7002,1295
,,,,7129,6516,7444,928
2012,Zurich,Hotels and restaurants,Lowest management,4985,4881,5074,193
2012,Zurich,Information and communication,Lowest management,9208,8341,9542,1201
2012,Zurich,Financial and insurance services,Lowest management,8604,8175,9004,829
2012,Zurich,Professional services,Lowest management,8223,8010,8360,350
,,,,6089,5690,6187,497
2012,Zurich,Health and social work,Lowest management,6380,6129,7030,901
,,,,6660,5659,7234,1575
,,,,5554,4771,6825,2054
2012,Zurich,TOTAL,No management,6074,5550,6422,872
2012,Zurich,SECTOR 2 PRODUCTION,No management,6088,5366,6225,859
,,,,5636,0,5687,5687
2012,Zurich,Manufacturing of Goods,No management,6120,5225,6445,1220
2012,Zurich,Waste disposal,No management,6190,6217,6190,-27
2012,Zurich,Construction ,No management,6007,5682,6030,348
2012,Zurich,SECTOR 3 SERVICES ,No management,6069,5573,6509,936
2012,Zurich,Wholesale and retail trade,No management,4973,4602,5727,1125
2012,Zurich,Transportation and storage,No management,5853,5229,6085,856
2012,Zurich,Hotels and restaurants,No management,4218,4147,4243,96
2012,Zurich,Information and communication,No management,8136,7040,8667,1627
2012,Zurich,Financial and insurance services,No management,7063,6676,7746,1070
2012,Zurich,Professional services,No management,6703,6341,7122,781
,,,,4751,4036,5108,1072
2012,Zurich,Health and social work,No management,6283,6196,6599,403
,,,,6071,5616,6707,1091
2012,Zurich,Other service activities,No management,5141,4747,5502,755
